"fipscode","state","jurisdiction","clinton","trump","johnson","stein","other","totalvotes"
1001,"Alabama","Autauga",5936,18172,546,105,214,24973
1003,"Alabama","Baldwin",18458,72883,2464,456,954,95215
1005,"Alabama","Barbour",4871,5454,93,18,33,10469
1007,"Alabama","Bibb",1874,6738,124,17,66,8819
1009,"Alabama","Blount",2156,22859,338,89,146,25588
1011,"Alabama","Bullock",3530,1140,22,10,8,4710
1013,"Alabama","Butler",3726,4901,65,13,27,8732
1015,"Alabama","Calhoun",13242,32865,1116,262,379,47864
1017,"Alabama","Chambers",5784,7843,168,44,61,13900
1019,"Alabama","Cherokee",1547,8953,147,26,60,10733
1021,"Alabama","Chilton",2911,15081,228,52,97,18369
1023,"Alabama","Choctaw",3109,4106,52,6,19,7292
1025,"Alabama","Clarke",5749,7140,99,17,26,13031
1027,"Alabama","Clay",1237,5245,93,16,33,6624
1029,"Alabama","Cleburne",684,5764,90,20,35,6593
1031,"Alabama","Coffee",4221,15875,396,104,171,20767
1033,"Alabama","Colbert",7312,16746,511,107,239,24915
1035,"Alabama","Conecuh",3080,3420,51,10,24,6585
1037,"Alabama","Coosa",1782,3381,53,14,22,5252
1039,"Alabama","Covington",2387,13267,183,36,67,15940
1041,"Alabama","Crenshaw",1664,4513,65,14,11,6267
1043,"Alabama","Cullman",3798,32989,687,134,265,37873
1045,"Alabama","Dale",4413,13808,350,62,116,18749
1047,"Alabama","Dallas",12836,5789,96,24,47,18792
1049,"Alabama","DeKalb",3622,21405,458,152,189,25826
1051,"Alabama","Elmore",8443,27634,738,112,333,37260
1053,"Alabama","Escambia",4605,9935,188,37,80,14845
1055,"Alabama","Etowah",10442,32353,835,164,370,44164
1057,"Alabama","Fayette",1362,6712,109,24,42,8249
1059,"Alabama","Franklin",2197,9466,238,54,85,12040
1061,"Alabama","Geneva",1525,9994,149,24,66,11758
1063,"Alabama","Greene",4013,838,13,5,11,4880
1065,"Alabama","Hale",4775,3173,54,12,26,8040
1067,"Alabama","Henry",2292,5632,91,17,40,8072
1069,"Alabama","Houston",10664,30728,779,144,324,42639
1071,"Alabama","Jackson",3673,16672,393,90,156,20984
1073,"Alabama","Jefferson",156873,134768,6645,1554,4351,304191
1075,"Alabama","Lamar",1036,5823,62,15,30,6966
1077,"Alabama","Lauderdale",9952,27899,987,222,465,39525
1079,"Alabama","Lawrence",3627,10833,250,31,88,14829
1081,"Alabama","Lee",21230,34617,2030,364,950,59191
1083,"Alabama","Limestone",9468,29067,1055,202,502,40294
1085,"Alabama","Lowndes",4883,1751,32,11,7,6684
1087,"Alabama","Macon",7566,1431,69,49,25,9140
1089,"Alabama","Madison",62822,89520,6621,1254,3172,163389
1091,"Alabama","Marengo",5615,5233,104,13,29,10994
1093,"Alabama","Marion",1432,11274,181,26,71,12984
1095,"Alabama","Marshall",4917,29233,678,158,330,35316
1097,"Alabama","Mobile",72186,95116,3291,791,1353,172737
1099,"Alabama","Monroe",4332,5795,88,17,39,10271
1101,"Alabama","Montgomery",58916,34003,1486,490,983,95878
1103,"Alabama","Morgan",11254,37486,1168,218,518,50644
1105,"Alabama","Perry",3824,1407,23,6,18,5278
1107,"Alabama","Pickens",3972,5456,49,19,46,9542
1109,"Alabama","Pike",5056,7693,257,48,114,13168
1111,"Alabama","Randolph",2291,7705,124,19,48,10187
1113,"Alabama","Russell",9579,9210,281,68,118,19256
1115,"Alabama","St Clair",5589,31651,684,130,346,38400
1117,"Alabama","Shelby",22977,73020,2965,480,1812,101254
1119,"Alabama","Sumter",4746,1581,57,14,13,6411
1121,"Alabama","Talladega",12121,20614,411,106,155,33407
1123,"Alabama","Tallapoosa",5519,13594,233,52,88,19486
1125,"Alabama","Tuscaloosa",31762,47723,1873,390,952,82700
1127,"Alabama","Walker",4497,24266,455,95,159,29472
1129,"Alabama","Washington",2374,6042,73,22,22,8533
1131,"Alabama","Wilcox",4339,1742,22,7,13,6123
1133,"Alabama","Winston",872,9228,131,29,53,10313
4001,"Arizona","Apache",17083,8240,1221,469,106,27119
4003,"Arizona","Cochise",17450,28092,2394,993,455,49384
4005,"Arizona","Coconino",32404,21108,2978,1414,536,58440
4007,"Arizona","Gila",7003,14182,803,212,112,22312
4009,"Arizona","Graham",3301,8025,497,116,195,12134
4011,"Arizona","Greenlee",1092,1892,200,59,27,3270
4012,"Arizona","LaPaz",1575,4003,211,73,15,5877
4013,"Arizona","Maricopa",702907,747361,67043,19432,12355,1549098
4015,"Arizona","Mohave",17455,58282,2639,740,230,79346
4017,"Arizona","Navajo",16459,20577,1410,703,505,39654
4019,"Arizona","Pima",224661,167428,15620,6200,2509,416418
4021,"Arizona","Pinal",47892,72819,5010,1476,1057,128254
4023,"Arizona","SantaCruz",11690,3897,432,221,47,16287
4025,"Arizona","Yavapai",35590,71330,3996,1588,652,113156
4027,"Arizona","Yuma",24605,25165,1873,649,124,52416
5001,"Arkansas","Arkansas",1939,3826,126,64,257,6212
5003,"Arkansas","Ashley",2408,5338,156,34,147,8083
5005,"Arkansas","Baxter",4169,14682,452,140,323,19766
5007,"Arkansas","Benton",28005,60871,3871,949,3128,96824
5009,"Arkansas","Boone",2926,12235,379,134,437,16111
5011,"Arkansas","Bradley",1317,2164,73,16,83,3653
5013,"Arkansas","Calhoun",639,1556,44,3,27,2269
5015,"Arkansas","Carroll",3342,6786,238,210,182,10758
5017,"Arkansas","Chicot",2350,1716,35,15,60,4176
5019,"Arkansas","Clark",3620,4404,196,68,238,8526
5021,"Arkansas","Clay",1199,3781,100,35,85,5200
5023,"Arkansas","Cleburne",2101,9458,229,63,234,12085
5025,"Arkansas","Cleveland",723,2462,59,8,102,3354
5027,"Arkansas","Columbia",3140,5456,117,40,134,8887
5029,"Arkansas","Conway",2656,4849,171,43,208,7927
5031,"Arkansas","Craighead",10538,22892,1031,304,808,35573
5033,"Arkansas","Crawford",4488,16686,581,173,522,22450
5035,"Arkansas","Crittenden",8410,6964,242,96,240,15952
5037,"Arkansas","Cross",1999,4584,105,24,162,6874
5039,"Arkansas","Dallas",1165,1509,26,12,59,2771
5041,"Arkansas","Desha",2228,1919,44,4,62,4257
5043,"Arkansas","Drew",2365,3968,111,43,108,6595
5045,"Arkansas","Faulkner",14629,29346,1675,511,1366,47527
5047,"Arkansas","Franklin",1376,5039,177,34,144,6770
5049,"Arkansas","Fulton",1067,3471,107,41,86,4772
5051,"Arkansas","Garland",12311,26087,989,387,1031,40805
5053,"Arkansas","Grant",1373,5725,177,30,140,7445
5055,"Arkansas","Greene",3071,10720,404,97,308,14600
5057,"Arkansas","Hempstead",2377,4401,106,22,143,7049
5059,"Arkansas","Hot Spring",3149,8172,239,112,272,11944
5061,"Arkansas","Howard",1351,3157,60,22,84,4674
5063,"Arkansas","Independence",2881,9936,352,85,360,13614
5065,"Arkansas","Izard",1113,4042,125,45,123,5448
5067,"Arkansas","Jackson",1583,3267,111,26,169,5156
5069,"Arkansas","Jefferson",15772,9250,296,157,419,25894
5071,"Arkansas","Johnson",2427,6091,294,90,210,9112
5073,"Arkansas","Lafayette",1032,1758,26,5,39,2860
5075,"Arkansas","Lawrence",1263,4064,165,39,154,5685
5077,"Arkansas","Lee",1735,1229,22,6,34,3026
5079,"Arkansas","Lincoln",1252,2455,48,16,55,3826
5081,"Arkansas","Little River",1397,3605,85,14,126,5227
5083,"Arkansas","Logan",1715,5746,195,54,211,7921
5085,"Arkansas","Lonoke",5664,19958,767,172,539,27100
5087,"Arkansas","Madison",1588,4928,144,54,127,6841
5089,"Arkansas","Marion",1434,5336,157,56,124,7107
5091,"Arkansas","Miller",4273,11294,237,69,218,16091
5093,"Arkansas","Mississippi",5670,7061,181,65,227,13204
5095,"Arkansas","Monroe",1312,1489,37,9,37,2884
5097,"Arkansas","Montgomery",748,2643,52,33,83,3559
5099,"Arkansas","Nevada",1157,2000,35,6,48,3246
5101,"Arkansas","Newton",699,2875,49,69,61,3753
5103,"Arkansas","Ouachita",4321,5351,97,24,142,9935
5105,"Arkansas","Perry",1049,3008,113,38,98,4306
5107,"Arkansas","Phillips",4310,2446,62,20,115,6953
5109,"Arkansas","Pike",685,3150,73,8,65,3981
5111,"Arkansas","Poinsett",1880,5502,154,34,152,7722
5113,"Arkansas","Polk",1212,6618,164,56,181,8231
5115,"Arkansas","Pope",5000,16256,618,225,470,22569
5117,"Arkansas","Prairie",814,2505,56,10,59,3444
5119,"Arkansas","Pulaski",89574,61257,4328,1553,3064,159776
5121,"Arkansas","Randolph",1425,4509,203,53,189,6379
5123,"Arkansas","St Francis",4031,3195,64,18,122,7430
5125,"Arkansas","Saline",13256,35863,1466,326,1189,52100
5127,"Arkansas","Scott",602,2731,83,25,69,3510
5129,"Arkansas","Searcy",601,2955,68,18,86,3728
5131,"Arkansas","Sebastian",12300,29127,1630,481,1099,44637
5133,"Arkansas","Sevier",1075,3282,83,20,102,4562
5135,"Arkansas","Sharp",1472,5407,155,49,166,7249
5137,"Arkansas","Stone",1203,4113,0,62,199,5577
5139,"Arkansas","Union",5855,10456,275,70,238,16894
5141,"Arkansas","Van Buren",1549,5382,182,53,173,7339
5143,"Arkansas","Washington",33366,41476,3360,1316,2343,81861
5145,"Arkansas","White",5170,21077,695,151,906,27999
5147,"Arkansas","Woodruff",1118,1347,45,12,49,2571
5149,"Arkansas","Yell",1480,4608,157,47,147,6439
6001,"California","Alameda",514842,95922,16906,17830,8766,654266
6003,"California","Alpine",334,217,25,21,5,602
6005,"California","Amador",6004,10485,804,227,214,17734
6007,"California","Butte",41567,45144,4625,2594,1634,95564
6009,"California","Calaveras",7944,13511,1104,424,153,23136
6011,"California","Colusa",2661,3551,260,85,75,6632
6013,"California","Contra Costa",319287,115956,16123,8637,6172,466175
6015,"California","Del Norte",3485,5134,416,245,278,9558
6017,"California","El Dorado",36404,49247,5027,1425,1488,93591
6019,"California","Fresno",141341,124049,9246,4300,3383,282319
6021,"California","Glenn",3065,5788,375,97,145,9470
6023,"California","Humboldt",33200,18373,2163,3681,1829,59246
6025,"California","Imperial",32667,12704,1221,745,754,48091
6027,"California","Inyo",3155,4248,328,214,141,8086
6029,"California","Kern",98689,129584,9359,2887,3644,244163
6031,"California","Kings",13617,18093,1338,411,456,33915
6033,"California","Lake",11496,10599,1095,930,376,24496
6035,"California","Lassen",2224,7574,473,105,148,10524
6037,"California","Los Angeles",2464364,769743,88968,76465,34768,3434308
6039,"California","Madera",17029,23357,1558,644,524,43112
6041,"California","Marin",108707,21771,4180,3109,1506,139273
6043,"California","Mariposa",3122,5185,326,189,55,8877
6045,"California","Mendocino",22079,10888,1331,2108,1071,37477
6047,"California","Merced",37317,28725,2410,1209,1128,70789
6049,"California","Modoc",877,2696,122,50,43,3788
6051,"California","Mono",2773,2111,222,142,28,5276
6053,"California","Monterey",89088,34895,4547,2823,2055,133408
6055,"California","Napa",39199,17411,2551,1262,949,61372
6057,"California","Nevada",26053,23365,2378,2189,950,54935
6059,"California","Orange",609961,507148,46128,18068,16216,1197521
6061,"California","Placer",73509,95138,9245,2501,2446,182839
6063,"California","Plumas",3459,5420,411,186,200,9676
6065,"California","Riverside",373695,333243,24089,11320,9044,751391
6067,"California","Sacramento",326023,189789,24412,9846,9260,559330
6069,"California","San Benito",12521,7841,815,364,383,21924
6071,"California","San Bernardino",340833,271240,21050,10604,10256,653983
6073,"California","San Diego",735476,477766,51663,22820,18675,1306400
6075,"California","San Francisco",345084,37688,8883,9904,4233,405792
6077,"California","San Joaquin",121124,88936,8049,3134,2923,224166
6079,"California","San Luis Obispo",67107,56164,6473,2848,2417,135009
6081,"California","San Mateo",237882,57929,9464,5102,4007,314384
6083,"California","Santa Barbara",107142,56365,6748,3719,2812,176786
6085,"California","Santa Clara",511684,144826,25325,12664,9210,703709
6087,"California","Santa Cruz",95249,22438,4325,4485,2324,128821
6089,"California","Shasta",22301,51778,3382,1300,1292,80053
6091,"California","Sierra",601,1048,98,42,41,1830
6093,"California","Siskiyou",7234,11341,875,575,467,20492
6095,"California","Solano",102360,51920,6254,2771,2808,166113
6097,"California","Sonoma",160435,51408,8987,7347,3076,231253
6099,"California","Stanislaus",81647,78494,6662,2562,2781,172146
6101,"California","Sutter",13076,18176,1437,382,452,33523
6103,"California","Tehama",6809,15494,953,290,362,23908
6105,"California","Trinity",2214,2812,302,239,119,5686
6107,"California","Tulare",47585,58299,3800,1620,1030,112334
6109,"California","Tuolumne",9123,14551,1101,384,370,25529
6111,"California","Ventura",194402,132323,13679,6315,5007,351726
6113,"California","Yolo",54752,20739,3346,1779,1474,82090
6115,"California","Yuba",7910,13170,1063,438,417,22998
8001,"Colorado","Adams",96558,80082,9893,2703,4429,193665
8003,"Colorado","Alamosa",3189,3046,405,117,182,6939
8005,"Colorado","Arapahoe",159885,117053,16002,3829,6277,303046
8007,"Colorado","Archuleta",2500,4264,331,116,128,7339
8009,"Colorado","Baca",283,1753,51,18,48,2153
8011,"Colorado","Bent",590,1188,83,20,46,1927
8013,"Colorado","Boulder",132334,41396,8034,3733,2645,188142
8014,"Colorado","Broomfield",19731,14367,2174,497,920,37689
8015,"Colorado","Chaffee",4888,5391,537,198,236,11250
8017,"Colorado","Cheyenne",132,925,31,4,10,1102
8019,"Colorado","Clear Creek",2729,2575,365,118,79,5866
8021,"Colorado","Conejos",1771,1914,166,24,147,4022
8023,"Colorado","Costilla",1125,588,83,19,33,1848
8025,"Colorado","Crowley",339,1079,63,11,35,1527
8027,"Colorado","Custer",797,2061,141,24,43,3066
8029,"Colorado","Delta",4087,11655,475,255,318,16790
8031,"Colorado","Denver",244551,62690,14861,5580,4170,331852
8033,"Colorado","Dolores",242,944,31,13,25,1255
8035,"Colorado","Douglas",68657,102573,10212,1477,4580,187499
8037,"Colorado","Eagle",14099,8990,1368,423,343,25223
8039,"Colorado","Elbert",3134,11705,666,138,335,15978
8041,"Colorado","El Paso",108010,179228,19877,4093,7759,318967
8043,"Colorado","Fremont",5297,15122,890,243,421,21973
8045,"Colorado","Garfield",11271,13132,1135,468,464,26470
8047,"Colorado","Gilpin",1634,1566,193,122,61,3576
8049,"Colorado","Grand",3358,4494,487,128,121,8588
8051,"Colorado","Gunnison",5128,3289,595,249,151,9412
8053,"Colorado","Hinsdale",197,339,27,11,15,589
8055,"Colorado","Huerfano",1633,1883,151,48,68,3783
8057,"Colorado","Jackson",171,629,41,7,13,861
8059,"Colorado","Jefferson",160776,138177,18537,4579,6813,328882
8061,"Colorado","Kiowa",91,728,24,1,11,855
8063,"Colorado","Kit Carson",536,2967,95,16,88,3702
8065,"Colorado","Lake",1616,1270,173,78,62,3199
8067,"Colorado","La Plata",15525,12587,1878,665,495,31150
8069,"Colorado","Larimer",93113,83430,11510,3203,4724,195980
8071,"Colorado","Las Animas",2650,3710,251,62,120,6793
8073,"Colorado","Lincoln",409,1892,77,9,49,2436
8075,"Colorado","Logan",1851,7282,319,65,205,9722
8077,"Colorado","Mesa",21729,49779,3675,712,1758,77653
8079,"Colorado","Mineral",237,344,42,11,18,652
8081,"Colorado","Moffat",874,5305,179,31,136,6525
8083,"Colorado","Montezuma",3973,7853,544,235,253,12858
8085,"Colorado","Montrose",5466,14382,735,138,465,21186
8087,"Colorado","Morgan",3151,8145,350,80,234,11960
8089,"Colorado","Otero",2943,4928,320,57,204,8452
8091,"Colorado","Ouray",1697,1351,150,61,51,3310
8093,"Colorado","Park",3421,6135,509,169,183,10417
8095,"Colorado","Phillips",436,1791,60,9,36,2332
8097,"Colorado","Pitkin",7333,2550,374,186,80,10523
8099,"Colorado","Prowers",1186,3531,155,30,114,5016
8101,"Colorado","Pueblo",35875,36265,4072,942,1492,78646
8103,"Colorado","Rio Blanco",436,2791,118,16,89,3450
8105,"Colorado","Rio Grande",2001,3085,232,61,155,5534
8107,"Colorado","Routt",7600,5230,722,206,228,13986
8109,"Colorado","Saguache",1417,1147,92,129,50,2835
8111,"Colorado","San Juan",265,215,17,4,5,506
8113,"Colorado","San Miguel",2975,1033,154,128,39,4329
8115,"Colorado","Sedgwick",267,1015,28,21,33,1364
8117,"Colorado","Summit",9557,5100,1000,302,215,16174
8119,"Colorado","Teller",3603,9745,674,165,257,14444
8121,"Colorado","Washington",296,2299,82,11,45,2733
8123,"Colorado","Weld",46519,76651,7487,1353,3418,135428
8125,"Colorado","Yuma",726,3850,118,16,81,4791
9001,"Connecticut","Bethel",4777,4575,318,152,24,9846
9001,"Connecticut","Bridgeport",32035,6596,428,490,11,39560
9001,"Connecticut","Brookfield",4216,4973,279,103,9,9580
9001,"Connecticut","Danbury",16084,11626,749,379,11,28849
9001,"Connecticut","Darien",5942,4625,586,80,32,11265
9001,"Connecticut","Easton",2203,2131,127,56,9,4526
9001,"Connecticut","Fairfield",18041,12112,985,348,67,31553
9001,"Connecticut","Greenwich",17630,12215,1050,271,43,31209
9001,"Connecticut","Monroe",4520,5922,353,95,18,10908
9001,"Connecticut","New Canaan",5767,4541,511,81,66,10966
9001,"Connecticut","New Fairfield",3071,4302,204,94,6,7677
9001,"Connecticut","Newtown",7448,7154,505,204,48,15359
9001,"Connecticut","Norwalk",24414,12324,968,490,36,38232
9001,"Connecticut","Redding",3127,2088,185,73,14,5487
9001,"Connecticut","Ridgefield",7907,5680,516,146,47,14296
9001,"Connecticut","Shelton",8001,12051,520,264,21,20857
9001,"Connecticut","Sherman",976,1065,67,28,1,2137
9001,"Connecticut","Stamford",34148,16222,1184,627,77,52258
9001,"Connecticut","Stratford",13729,10534,570,368,50,25251
9001,"Connecticut","Trumbull",9299,9753,495,224,75,19846
9001,"Connecticut","Weston",3807,1633,208,58,6,5712
9001,"Connecticut","Westport",10655,4169,472,124,24,15444
9001,"Connecticut","Wilton",6055,3786,411,111,28,10391
9003,"Connecticut","Avon",5675,4390,361,141,35,10602
9003,"Connecticut","Berlin",4913,6210,326,142,10,11601
9003,"Connecticut","Bloomfield",9637,1683,183,124,12,11639
9003,"Connecticut","Bristol",12499,12752,734,436,34,26455
9003,"Connecticut","Burlington",2352,2773,201,56,3,5385
9003,"Connecticut","Canton",3100,2601,187,100,14,6002
9003,"Connecticut","East Granby",1389,1371,149,36,5,2950
9003,"Connecticut","East Hartford",13180,5213,406,233,15,19047
9003,"Connecticut","East Windsor",2441,2606,158,89,7,5301
9003,"Connecticut","Enfield",8646,9233,755,299,26,18959
9003,"Connecticut","Farmington",7634,5977,477,185,30,14303
9003,"Connecticut","Glastonbury",11074,7533,726,247,45,19625
9003,"Connecticut","Granby",3114,2967,292,115,21,6509
9003,"Connecticut","Hartford",30375,2531,356,401,4,33667
9003,"Connecticut","Hartland",349,804,48,31,6,1238
9003,"Connecticut","Manchester",15109,8358,864,469,38,24838
9003,"Connecticut","Marlborough",1687,1766,128,46,12,3639
9003,"Connecticut","New Britain",15468,6055,406,381,18,22328
9003,"Connecticut","Newington",8425,6557,479,213,17,15691
9003,"Connecticut","Plainville",3802,4492,254,151,4,8703
9003,"Connecticut","Rocky Hill",5090,4331,304,105,8,9838
9003,"Connecticut","Simsbury",7825,5357,598,161,43,13984
9003,"Connecticut","Southington",9890,12383,743,275,27,23318
9003,"Connecticut","South Windsor",7721,5557,498,166,12,13954
9003,"Connecticut","Suffield",3334,3789,307,111,17,7558
9003,"Connecticut","West Hartford",23781,8055,993,445,72,33346
9003,"Connecticut","Wethersfield",7734,5794,447,194,53,14222
9003,"Connecticut","Windsor",11370,4013,385,231,17,16016
9003,"Connecticut","Windsor Locks",2789,3022,232,97,6,6146
9005,"Connecticut","Barkhamsted",905,1157,94,37,7,2200
9005,"Connecticut","Bethlehem",801,1405,59,47,5,2317
9005,"Connecticut","Bridgewater",518,571,33,17,2,1141
9005,"Connecticut","Canaan",357,203,23,9,0,592
9005,"Connecticut","Colebrook",324,528,28,18,1,899
9005,"Connecticut","Cornwall",622,248,27,26,0,923
9005,"Connecticut","Goshen",673,1064,61,25,0,1823
9005,"Connecticut","Harwinton",1131,2107,117,41,11,3407
9005,"Connecticut","Kent",1081,559,45,27,4,1716
9005,"Connecticut","Litchfield",2171,2434,180,66,8,4859
9005,"Connecticut","Morris",510,838,41,24,5,1418
9005,"Connecticut","New Hartford",1654,2243,146,77,2,4122
9005,"Connecticut","New Millford",6136,6865,433,214,20,13668
9005,"Connecticut","Norfolk",547,373,20,26,1,967
9005,"Connecticut","North Canaan",732,703,52,22,0,1509
9005,"Connecticut","Plymouth",1884,3767,113,42,4,5810
9005,"Connecticut","Roxbury",765,638,55,16,0,1474
9005,"Connecticut","Salisbury",1671,545,73,38,4,2331
9005,"Connecticut","Sharon",820,521,50,25,0,1416
9005,"Connecticut","Thomaston",1152,2616,152,50,1,3971
9005,"Connecticut","Torrington",5713,8673,515,214,16,15131
9005,"Connecticut","Warren",352,451,35,16,4,858
9005,"Connecticut","Washington",1242,738,57,41,4,2082
9005,"Connecticut","Watertown",3732,7730,300,122,0,11884
9005,"Connecticut","Winchester",1816,2903,146,122,7,4994
9005,"Connecticut","Woodbury",2466,3171,149,79,65,5930
9007,"Connecticut","Chester",1365,781,82,41,4,2273
9007,"Connecticut","Clinton",3493,3415,176,98,9,7191
9007,"Connecticut","Cromwell",3808,3486,289,111,20,7714
9007,"Connecticut","Deep River",1412,1077,74,41,2,2606
9007,"Connecticut","Durham",1898,2156,158,63,6,4281
9007,"Connecticut","East Haddam",2331,2487,164,95,10,5087
9007,"Connecticut","East Hampton",3210,3648,277,88,22,7245
9007,"Connecticut","Essex",2291,1620,114,67,0,4092
9007,"Connecticut","Haddam",2141,2556,171,93,9,4970
9007,"Connecticut","Killingworth",1895,1943,119,55,3,4015
9007,"Connecticut","Middlefield",1154,1361,78,38,5,2636
9007,"Connecticut","Middletown",12959,7126,639,485,35,21244
9007,"Connecticut","Old Saybrook",3207,2784,133,85,16,6225
9007,"Connecticut","Portland",2494,2491,186,82,0,5253
9007,"Connecticut","Westbrook",1699,1936,100,55,2,3792
9009,"Connecticut","Ansonia",3532,3621,209,112,4,7478
9009,"Connecticut","Beacon Falls",1146,2002,134,46,4,3332
9009,"Connecticut","Bethany",1580,1646,112,39,3,3380
9009,"Connecticut","Branford",8453,6585,344,201,22,15605
9009,"Connecticut","Cheshire",7572,7105,538,189,17,15421
9009,"Connecticut","Derby",2332,2651,109,58,0,5150
9009,"Connecticut","East Haven",5425,6867,218,147,0,12657
9009,"Connecticut","Guilford",7864,4929,338,159,33,13323
9009,"Connecticut","Hamden",18962,7790,549,348,46,27695
9009,"Connecticut","Madison",5935,4500,334,120,24,10913
9009,"Connecticut","Meriden",12788,8660,635,348,12,22443
9009,"Connecticut","Middlebury",1664,2630,148,45,8,4495
9009,"Connecticut","Milford",13598,13383,791,349,30,28151
9009,"Connecticut","Naugatuck",5219,7310,440,199,14,13182
9009,"Connecticut","New Haven",35933,4540,493,618,104,41688
9009,"Connecticut","North Branford",2933,4473,175,68,5,7654
9009,"Connecticut","North Haven",5837,7268,323,146,15,13589
9009,"Connecticut","Orange",3834,4221,216,86,10,8367
9009,"Connecticut","Oxford",2398,4685,178,64,18,7343
9009,"Connecticut","Prospect",1661,3701,156,58,9,5585
9009,"Connecticut","Seymour",3024,4824,227,117,14,8206
9009,"Connecticut","Southbury",5013,6100,347,103,17,11580
9009,"Connecticut","Wallingford",10651,10940,716,301,28,22636
9009,"Connecticut","Waterbury",19870,12837,612,391,9,33719
9009,"Connecticut","West Haven",12477,7774,422,287,9,20969
9009,"Connecticut","Wolcott",2575,6192,235,85,5,9092
9009,"Connecticut","Woodbridge",3333,1814,120,73,13,5353
9011,"Connecticut","Bozrah",536,764,58,31,1,1390
9011,"Connecticut","Colchester",3898,4108,407,143,35,8591
9011,"Connecticut","East Lyme",5512,4214,330,144,13,10213
9011,"Connecticut","Franklin",413,613,48,19,4,1097
9011,"Connecticut","Griswold",1934,3012,232,89,9,5276
9011,"Connecticut","Groton",8453,5936,662,272,34,15357
9011,"Connecticut","Lebanon",1583,2115,174,66,10,3948
9011,"Connecticut","Ledyard",3336,3471,350,116,27,7300
9011,"Connecticut","Lisbon",868,1175,83,52,3,2181
9011,"Connecticut","Lyme",1019,567,73,28,4,1691
9011,"Connecticut","Montville",3340,4156,327,149,0,7972
9011,"Connecticut","New London",6305,1924,217,237,4,8687
9011,"Connecticut","North Stonington",1289,1560,124,51,6,3030
9011,"Connecticut","Norwich",7453,5217,511,282,13,13476
9011,"Connecticut","Old Lyme",2498,1999,142,63,7,4709
9011,"Connecticut","Preston",978,1377,97,52,10,2514
9011,"Connecticut","Salem",1029,1182,98,34,3,2346
9011,"Connecticut","Sprague",535,864,78,30,2,1509
9011,"Connecticut","Stonington",5635,4081,302,144,11,10173
9011,"Connecticut","Voluntown",431,862,63,29,0,1385
9011,"Connecticut","Waterford",5233,4861,368,189,32,10683
9013,"Connecticut","Andover",896,891,79,42,0,1908
9013,"Connecticut","Bolton",1385,1436,120,49,12,3002
9013,"Connecticut","Columbia",1558,1500,151,64,11,3284
9013,"Connecticut","Coventry",3083,3262,314,112,12,6783
9013,"Connecticut","Ellington",3531,4199,322,115,35,8202
9013,"Connecticut","Hebron",2627,2555,206,82,16,5486
9013,"Connecticut","Mansfield",8309,2433,429,280,30,11481
9013,"Connecticut","Somers",2125,3350,163,46,10,5694
9013,"Connecticut","Stafford",2286,3344,296,106,2,6034
9013,"Connecticut","Tolland",4020,3908,399,146,26,8499
9013,"Connecticut","Union",188,277,22,9,0,496
9013,"Connecticut","Vernon",7084,5666,553,237,19,13559
9013,"Connecticut","Willington",1414,1373,127,82,0,2996
9015,"Connecticut","Ashford",1112,1042,108,63,7,2332
9015,"Connecticut","Brooklyn",1462,2052,141,60,5,3720
9015,"Connecticut","Canterbury",932,1609,111,50,10,2712
9015,"Connecticut","Chaplin",434,624,55,34,4,1151
9015,"Connecticut","Eastford",367,513,48,21,13,962
9015,"Connecticut","Hampton",484,509,37,27,2,1059
9015,"Connecticut","Killingly",2491,3916,326,141,14,6888
9015,"Connecticut","Plainfield",2177,3512,300,123,8,6120
9015,"Connecticut","Pomfret",1084,1014,94,33,7,2232
9015,"Connecticut","Putnam",1562,1845,161,83,6,3657
9015,"Connecticut","Scotland",310,518,58,22,1,909
9015,"Connecticut","Sterling",478,1102,67,37,0,1684
9015,"Connecticut","Thompson",1579,2646,216,66,1,4508
9015,"Connecticut","Windham",5375,2564,271,183,10,8403
9015,"Connecticut","Woodstock",1945,2281,187,67,6,4486
10001,"Delaware","Kent",33351,36991,2876,1042,NA,74260
10003,"Delaware","New Castle",162919,85525,9107,3956,NA,261507
10005,"Delaware","Sussex",39333,62611,2774,1105,NA,105823
12001,"Florida","Alachua",75820,46834,4059,1507,351,128571
12003,"Florida","Baker",2112,10294,169,30,29,12634
12005,"Florida","Bay",21797,62194,2652,562,248,87453
12007,"Florida","Bradford",2924,8913,177,47,37,12098
12009,"Florida","Brevard",119679,181848,9451,2708,1066,314752
12011,"Florida","Broward",553320,260951,11078,5094,1508,831951
12013,"Florida","Calhoun",1241,4655,124,25,36,6081
12015,"Florida","Charlotte",33445,60218,1946,567,198,96374
12017,"Florida","Citrus",22789,54456,1724,480,251,79700
12019,"Florida","Clay",27822,74963,2806,571,321,106483
12021,"Florida","Collier",61085,105423,3263,747,271,170789
12023,"Florida","Columbia",7601,20368,523,150,65,28707
12027,"Florida","Desoto",3781,6778,166,53,40,10818
12029,"Florida","Dixie",1270,5822,77,21,12,7202
12031,"Florida","Duval",205704,211672,11318,2912,1089,432695
12033,"Florida","Escambia",57461,88808,4612,1055,533,152469
12035,"Florida","Flagler",22026,33850,1114,388,125,57503
12037,"Florida","Franklin",1744,4125,95,33,18,6015
12039,"Florida","Gadsden",15020,6728,229,78,58,22113
12041,"Florida","Gilchrist",1458,6740,155,43,24,8420
12043,"Florida","Glades",1271,2996,54,18,14,4353
12045,"Florida","Gulf",1720,5329,195,27,22,7293
12047,"Florida","Hamilton",1904,3443,79,17,17,5460
12049,"Florida","Hardee",2149,5242,140,24,28,7583
12051,"Florida","Hendry",4615,6195,207,52,46,11115
12053,"Florida","Hernando",31795,58970,2051,710,270,93796
12055,"Florida","Highlands",14937,29565,854,186,144,45686
12057,"Florida","Hillsborough",307896,266870,15703,5032,2159,597660
12059,"Florida","Holmes",853,7483,133,19,26,8514
12061,"Florida","Indian River",29043,48620,1723,419,204,80009
12063,"Florida","Jackson",6397,14257,266,60,61,21041
12065,"Florida","Jefferson",3541,3930,110,42,22,7645
12067,"Florida","Lafayette",518,2809,47,10,8,3392
12069,"Florida","Lake",62838,102188,3985,975,476,170462
12071,"Florida","Lee",124908,191551,6982,2127,852,326420
12073,"Florida","Leon",92068,53821,4403,1366,474,152132
12075,"Florida","Levy",5101,13775,358,102,59,19395
12077,"Florida","Liberty",651,2543,76,17,9,3296
12079,"Florida","Madison",3526,4851,95,22,11,8505
12081,"Florida","Manatee",71224,101944,4177,1149,464,178958
12083,"Florida","Marion",62041,107833,3365,972,489,174700
12085,"Florida","Martin",30185,53204,1804,474,125,85792
12086,"Florida","Miami-Dade",624146,333999,13219,5985,2855,980204
12087,"Florida","Monroe",18971,21904,1131,398,74,42478
12089,"Florida","Nassau",10869,34266,1195,188,89,46607
12091,"Florida","Okaloosa",23780,71893,4171,611,400,100855
12093,"Florida","Okeechobee",3959,9356,234,53,51,13653
12095,"Florida","Orange",329894,195216,14483,4777,1905,546275
12097,"Florida","Osceola",85458,50301,2811,1003,633,140206
12099,"Florida","Palm Beach",374673,272402,10370,3723,1164,662332
12101,"Florida","Pasco",90142,142101,6129,1908,859,241139
12103,"Florida","Pinellas",233701,239201,13627,4611,1263,492403
12105,"Florida","Polk",117433,157430,6810,1647,994,284314
12107,"Florida","Putnam",10094,22138,597,219,69,33117
12109,"Florida","St. Johns",43099,88684,3612,864,255,136514
12111,"Florida","St. Lucie",66881,70289,2475,867,335,140847
12113,"Florida","Santa Rosa",18464,65339,3123,524,295,87745
12115,"Florida","Sarasota",97870,124438,4715,1596,444,229063
12117,"Florida","Seminole",105914,109443,6811,1974,754,224896
12119,"Florida","Sumter",22638,52730,971,201,125,76665
12121,"Florida","Suwannee",3964,14287,309,81,53,18694
12123,"Florida","Taylor",2152,6930,151,33,24,9290
12125,"Florida","Union",1014,4568,90,12,10,5694
12127,"Florida","Volusia",109091,143007,6111,2003,657,260869
12129,"Florida","Wakulla",4348,10512,378,66,47,15351
12131,"Florida","Walton",6876,25756,783,142,80,33637
12133,"Florida","Washington",2264,8637,192,22,41,11156
13001,"Georgia","Appling",1434,5494,77,NA,NA,7005
13003,"Georgia","Atkinson",697,1878,35,NA,NA,2610
13005,"Georgia","Bacon",608,3364,47,NA,NA,4019
13007,"Georgia","Baker",650,775,15,NA,NA,1440
13009,"Georgia","Baldwin",7970,7697,419,NA,NA,16086
13011,"Georgia","Banks",684,6134,132,NA,NA,6950
13013,"Georgia","Barrow",6580,21108,1143,NA,NA,28831
13015,"Georgia","Bartow",8212,29911,1183,NA,NA,39306
13017,"Georgia","Ben Hill",2101,3739,91,NA,NA,5931
13019,"Georgia","Berrien",1047,5422,115,NA,NA,6584
13021,"Georgia","Bibb",36787,24043,1447,NA,NA,62277
13023,"Georgia","Bleckley",1101,3719,123,NA,NA,4943
13025,"Georgia","Brantley",619,5567,106,NA,NA,6292
13027,"Georgia","Brooks",2528,3701,89,NA,NA,6318
13029,"Georgia","Bryan",4014,10529,542,NA,NA,15085
13031,"Georgia","Bulloch",9261,15097,890,NA,NA,25248
13033,"Georgia","Burke",4731,4491,129,NA,NA,9351
13035,"Georgia","Butts",2566,6717,194,NA,NA,9477
13037,"Georgia","Calhoun",1179,830,16,NA,NA,2025
13039,"Georgia","Camden",5930,12310,629,NA,NA,18869
13043,"Georgia","Candler",1026,2664,73,NA,NA,3763
13045,"Georgia","Carroll",12464,30029,1346,NA,NA,43839
13047,"Georgia","Catoosa",4771,20876,881,NA,NA,26528
13049,"Georgia","Charlton",1004,2951,54,NA,NA,4009
13051,"Georgia","Chatham",62290,45688,3503,NA,NA,111481
13053,"Georgia","Chattahoochee",594,751,45,NA,NA,1390
13055,"Georgia","Chattooga",1613,6462,177,NA,NA,8252
13057,"Georgia","Cherokee",25231,80649,5015,NA,NA,110895
13059,"Georgia","Clarke",29603,12717,2019,NA,NA,44339
13061,"Georgia","Clay",697,566,8,NA,NA,1271
13063,"Georgia","Clayton",78220,12645,1647,NA,NA,92512
13065,"Georgia","Clinch",686,1727,34,NA,NA,2447
13067,"Georgia","Cobb",160121,152912,14466,NA,NA,327499
13069,"Georgia","Coffee",4094,9588,233,NA,NA,13915
13071,"Georgia","Colquitt",3463,9898,240,NA,NA,13601
13073,"Georgia","Columbia",18887,43085,2270,NA,NA,64242
13075,"Georgia","Cook",1753,4176,112,NA,NA,6041
13077,"Georgia","Coweta",16583,42533,2235,NA,NA,61351
13079,"Georgia","Crawford",1421,3635,106,NA,NA,5162
13081,"Georgia","Crisp",2837,4549,126,NA,NA,7512
13083,"Georgia","Dade",965,5051,226,NA,NA,6242
13085,"Georgia","Dawson",1448,9900,356,NA,NA,11704
13087,"Georgia","Decatur",4124,6020,126,NA,NA,10270
13089,"Georgia","DeKalb",251370,51468,9666,NA,NA,312504
13091,"Georgia","Dodge",1839,5021,138,NA,NA,6998
13093,"Georgia","Dooly",1872,1951,36,NA,NA,3859
13095,"Georgia","Dougherty",23311,10232,475,NA,NA,34018
13097,"Georgia","Douglas",31005,24817,1594,NA,NA,57416
13099,"Georgia","Early",2168,2552,65,NA,NA,4785
13101,"Georgia","Echols",156,1007,13,NA,NA,1176
13103,"Georgia","Effingham",4853,17874,679,NA,NA,23406
13105,"Georgia","Elbert",2539,5292,139,NA,NA,7970
13107,"Georgia","Emanuel",2435,5335,75,NA,NA,7845
13109,"Georgia","Evans",1130,2404,68,NA,NA,3602
13111,"Georgia","Fannin",1923,9632,222,NA,NA,11777
13113,"Georgia","Fayette",23284,35048,2103,NA,NA,60435
13115,"Georgia","Floyd",9159,24114,1084,NA,NA,34357
13117,"Georgia","Forsyth",23462,69851,4091,NA,NA,97404
13119,"Georgia","Franklin",1243,7054,177,NA,NA,8474
13121,"Georgia","Fulton",297051,117783,15765,NA,NA,430599
13123,"Georgia","Gilmer",1965,10477,293,NA,NA,12735
13125,"Georgia","Glascock",138,1235,17,NA,NA,1390
13127,"Georgia","Glynn",11775,21512,825,NA,NA,34112
13129,"Georgia","Gordon",3181,15191,507,NA,NA,18879
13131,"Georgia","Grady",3013,6053,135,NA,NA,9201
13133,"Georgia","Greene",3199,5490,151,NA,NA,8840
13135,"Georgia","Gwinnett",166153,146989,12494,NA,NA,325636
13137,"Georgia","Habersham",2483,13190,461,NA,NA,16134
13139,"Georgia","Hall",16180,51733,2307,NA,NA,70220
13141,"Georgia","Hancock",2701,843,36,NA,NA,3580
13143,"Georgia","Haralson",1475,9585,264,NA,NA,11324
13145,"Georgia","Harris",4086,11936,379,NA,NA,16401
13147,"Georgia","Hart",2585,7286,209,NA,NA,10080
13149,"Georgia","Heard",743,3370,93,NA,NA,4206
13151,"Georgia","Henry",50057,45724,2505,NA,NA,98286
13153,"Georgia","Houston",22553,35430,1761,NA,NA,59744
13155,"Georgia","Irwin",891,2716,58,NA,NA,3665
13157,"Georgia","Jackson",4491,21784,834,NA,NA,27109
13159,"Georgia","Jasper",1544,4360,119,NA,NA,6023
13161,"Georgia","Jeff Davis",901,4104,86,NA,NA,5091
13163,"Georgia","Jefferson",3821,3063,70,NA,NA,6954
13165,"Georgia","Jenkins",1123,1895,34,NA,NA,3052
13167,"Georgia","Johnson",1136,2519,27,NA,NA,3682
13169,"Georgia","Jones",3961,8305,260,NA,NA,12526
13171,"Georgia","Lamar",2270,5190,126,NA,NA,7586
13173,"Georgia","Lanier",806,1984,73,NA,NA,2863
13175,"Georgia","Laurens",6752,12411,313,NA,NA,19476
13177,"Georgia","Lee",3170,10646,299,NA,NA,14115
13179,"Georgia","Liberty",9556,6134,427,NA,NA,16117
13181,"Georgia","Lincoln",1273,2759,70,NA,NA,4102
13183,"Georgia","Long",1360,2626,131,NA,NA,4117
13185,"Georgia","Lowndes",15064,21635,929,NA,NA,37628
13187,"Georgia","Lumpkin",2220,9619,495,NA,NA,12334
13189,"Georgia","McDuffie",3699,5432,137,NA,NA,9268
13191,"Georgia","McIntosh",2303,3487,113,NA,NA,5903
13193,"Georgia","Macon",2705,1540,42,NA,NA,4287
13195,"Georgia","Madison",2425,9201,328,NA,NA,11954
13197,"Georgia","Marion",1213,1921,49,NA,NA,3183
13199,"Georgia","Meriwether",3804,5222,165,NA,NA,9191
13201,"Georgia","Miller",623,1891,30,NA,NA,2544
13205,"Georgia","Mitchell",3493,4279,93,NA,NA,7865
13207,"Georgia","Monroe",3571,8832,284,NA,NA,12687
13209,"Georgia","Montgomery",847,2670,45,NA,NA,3562
13211,"Georgia","Morgan",2663,6559,218,NA,NA,9440
13213,"Georgia","Murray",1800,10341,283,NA,NA,12424
13215,"Georgia","Muscogee",39851,26976,1831,NA,NA,68658
13217,"Georgia","Newton",21943,20913,947,NA,NA,43803
13219,"Georgia","Oconee",5581,13425,925,NA,NA,19931
13221,"Georgia","Oglethorpe",1831,4625,199,NA,NA,6655
13223,"Georgia","Paulding",18025,44662,1954,NA,NA,64641
13225,"Georgia","Peach",5100,5413,211,NA,NA,10724
13227,"Georgia","Pickens",1979,11651,354,NA,NA,13984
13229,"Georgia","Pierce",903,6302,93,NA,NA,7298
13231,"Georgia","Pike",1240,7278,163,NA,NA,8681
13233,"Georgia","Polk",2867,11014,289,NA,NA,14170
13235,"Georgia","Pulaski",1104,2437,58,NA,NA,3599
13237,"Georgia","Putnam",2758,6544,170,NA,NA,9472
13239,"Georgia","Quitman",461,575,8,NA,NA,1044
13241,"Georgia","Rabun",1444,6287,219,NA,NA,7950
13243,"Georgia","Randolph",1598,1271,28,NA,NA,2897
13245,"Georgia","Richmond",48814,24461,1811,NA,NA,75086
13247,"Georgia","Rockdale",23255,13478,923,NA,NA,37656
13249,"Georgia","Schley",401,1472,36,NA,NA,1909
13251,"Georgia","Screven",2300,3305,94,NA,NA,5699
13253,"Georgia","Seminole",1189,2345,48,NA,NA,3582
13255,"Georgia","Spalding",9357,15646,597,NA,NA,25600
13257,"Georgia","Stephens",1837,7686,243,NA,NA,9766
13259,"Georgia","Stewart",1222,805,28,NA,NA,2055
13261,"Georgia","Sumter",5520,5276,178,NA,NA,10974
13263,"Georgia","Talbot",2002,1196,46,NA,NA,3244
13265,"Georgia","Taliaferro",545,349,3,NA,NA,897
13267,"Georgia","Tattnall",1681,5096,109,NA,NA,6886
13269,"Georgia","Taylor",1296,2064,45,NA,NA,3405
13271,"Georgia","Telfair",1313,2450,32,NA,NA,3795
13273,"Georgia","Terrell",2267,1874,40,NA,NA,4181
13275,"Georgia","Thomas",7142,11228,368,NA,NA,18738
13277,"Georgia","Tift",4347,9584,244,NA,NA,14175
13279,"Georgia","Toombs",2338,6615,158,NA,NA,9111
13281,"Georgia","Towns",1210,5383,146,NA,NA,6739
13283,"Georgia","Treutlen",862,1809,32,NA,NA,2703
13285,"Georgia","Troup",9713,15750,561,NA,NA,26024
13287,"Georgia","Turner",1246,2095,53,NA,NA,3394
13289,"Georgia","Twiggs",1971,2035,50,NA,NA,4056
13291,"Georgia","Union",1963,9852,229,NA,NA,12044
13293,"Georgia","Upson",3475,7292,167,NA,NA,10934
13295,"Georgia","Walker",4215,18950,791,NA,NA,23956
13297,"Georgia","Walton",8292,31125,1055,NA,NA,40472
13299,"Georgia","Ware",3440,8513,206,NA,NA,12159
13301,"Georgia","Warren",1314,991,28,NA,NA,2333
13303,"Georgia","Washington",4200,4149,98,NA,NA,8447
13305,"Georgia","Wayne",2041,8153,192,NA,NA,10386
13307,"Georgia","Webster",473,630,13,NA,NA,1116
13309,"Georgia","Wheeler",646,1421,35,NA,NA,2102
13311,"Georgia","White",1674,9761,348,NA,NA,11783
13313,"Georgia","Whitfield",7937,21537,924,NA,NA,30398
13315,"Georgia","Wilcox",852,2096,25,NA,NA,2973
13317,"Georgia","Wilkes",1848,2572,57,NA,NA,4477
13319,"Georgia","Wilkinson",1894,2333,51,NA,NA,4278
13321,"Georgia","Worth",2020,6152,108,NA,NA,8280
15001,"Hawaii","County of Hawaii",41259,17501,2470,2852,785,64867
15003,"Hawaii","City and County of Honolulu",175696,90326,10467,6476,2825,285790
15007,"Hawaii","County of Kauai",16456,7574,982,1019,304,26335
15009,"Hawaii","County of Maui",33480,13446,2035,2390,594,51945
16001,"Idaho","Ada",75677,93752,9984,3138,13118,195669
16003,"Idaho","Adams",415,1556,83,19,110,2183
16005,"Idaho","Bannock",10342,17180,1471,518,3905,33416
16007,"Idaho","Bear Lake",255,2203,54,11,405,2928
16009,"Idaho","Benewah",770,3103,151,42,119,4185
16011,"Idaho","Bingham",2924,10907,417,124,2253,16625
16013,"Idaho","Blaine",6416,3340,424,176,368,10724
16015,"Idaho","Boise",777,2673,173,35,156,3814
16017,"Idaho","Bonner",5819,13343,762,396,623,20943
16019,"Idaho","Bonneville",8930,26699,1634,399,6559,44221
16021,"Idaho","Boundary",933,3789,161,80,200,5163
16023,"Idaho","Butte",160,914,25,7,124,1230
16025,"Idaho","Camas",110,410,23,6,41,590
16027,"Idaho","Canyon",16883,47222,2778,797,5105,72785
16029,"Idaho","Caribou",271,2275,64,15,410,3035
16031,"Idaho","Cassia",1036,5949,202,37,954,8178
16033,"Idaho","Clark",44,203,4,1,31,283
16035,"Idaho","Clearwater",704,2852,97,38,110,3801
16037,"Idaho","Custer",427,1777,67,30,113,2414
16039,"Idaho","Elmore",1814,5816,332,77,483,8522
16041,"Idaho","Franklin",385,3901,117,30,1066,5499
16043,"Idaho","Fremont",651,4090,127,20,827,5715
16045,"Idaho","Gem",1229,5980,241,57,447,7954
16047,"Idaho","Gooding",930,3743,110,30,378,5191
16049,"Idaho","Idaho",1196,6441,254,52,290,8233
16051,"Idaho","Jefferson",976,8436,274,55,1734,11475
16053,"Idaho","Jerome",1329,4644,218,52,508,6751
16055,"Idaho","Kootenai",16264,44449,2604,744,2249,66310
16057,"Idaho","Latah",8093,7265,1197,463,1155,18173
16059,"Idaho","Lemhi",733,3011,138,31,183,4096
16061,"Idaho","Lewis",270,1202,62,13,43,1590
16063,"Idaho","Lincoln",360,1184,54,18,132,1748
16065,"Idaho","Madison",1201,8941,612,69,4865,15688
16067,"Idaho","Minidoka",1167,4887,207,41,569,6871
16069,"Idaho","Nez Perce",4828,10699,879,203,592,17201
16071,"Idaho","Oneida",184,1531,37,3,313,2068
16073,"Idaho","Owyhee",591,3052,108,26,148,3925
16075,"Idaho","Payette",1507,6489,247,59,402,8704
16077,"Idaho","Power",699,1666,92,26,275,2758
16079,"Idaho","Shoshone",1384,3297,219,54,166,5120
16081,"Idaho","Teton",2159,2167,184,99,367,4976
16083,"Idaho","Twin Falls",6233,19828,1076,326,2411,29874
16085,"Idaho","Valley",1913,2906,230,53,247,5349
16087,"Idaho","Washington",776,3283,138,26,232,4455
17001,"Illinois","ADAMS",7680,22790,1168,249,60,31947
17003,"Illinois","ALEXANDER",1262,1496,48,14,0,2820
17005,"Illinois","BOND",2071,4889,447,67,36,7510
17007,"Illinois","BOONE",8998,12282,1068,330,51,22729
17009,"Illinois","BROWN",476,1796,77,10,0,2359
17011,"Illinois","BUREAU",6033,9287,842,197,30,16389
17013,"Illinois","CALHOUN",739,1721,72,26,3,2561
17015,"Illinois","CARROLL",2452,4434,395,98,14,7393
17017,"Illinois","CASS",1624,3216,172,51,12,5075
17019,"Illinois","CHAMPAIGN",50162,33371,4566,1847,623,90569
17021,"Illinois","CHRISTIAN",3993,10543,662,149,17,15364
17023,"Illinois","CLARK",1882,5622,277,49,11,7841
17025,"Illinois","CLAY",1024,5021,209,48,12,6314
17027,"Illinois","CLINTON",3948,12412,813,125,29,17327
17029,"Illinois","COLES",7312,13003,1025,287,52,21679
17031,"Illinois","COOK",1611946,453287,58678,32484,2220,2158615
17033,"Illinois","CRAWFORD",1992,6277,324,68,11,8672
17035,"Illinois","CUMBERLAND",1031,4206,238,47,4,5526
17037,"Illinois","DEKALB",20466,19091,2482,751,213,43003
17039,"Illinois","DEWITT",1910,5077,431,61,13,7492
17041,"Illinois","DOUGLAS",1949,5698,362,90,26,8125
17043,"Illinois","DUPAGE",228622,166415,20357,6367,1905,423666
17045,"Illinois","EDGAR",1793,5645,328,49,26,7841
17047,"Illinois","EDWARDS",434,2778,91,12,9,3324
17049,"Illinois","EFFINGHAM",3083,13635,644,100,52,17514
17051,"Illinois","FAYETTE",1819,7372,283,57,21,9552
17053,"Illinois","FORD",1414,4480,323,87,34,6338
17055,"Illinois","FRANKLIN",4727,13116,541,183,0,18567
17057,"Illinois","FULTON",6133,8492,780,239,7,15651
17059,"Illinois","GALLATIN",657,1942,73,20,7,2699
17061,"Illinois","GREENE",1205,4145,164,39,6,5559
17063,"Illinois","GRUNDY",8065,13454,1140,323,40,23022
17065,"Illinois","HAMILTON",802,3206,114,24,10,4156
17067,"Illinois","HANCOCK",2139,6430,348,64,68,9049
17069,"Illinois","HARDIN",420,1653,46,18,0,2137
17071,"Illinois","HENDERSON",1155,2155,158,19,2,3489
17073,"Illinois","HENRY",8871,13985,1243,200,66,24365
17075,"Illinois","IROQUOIS",2504,9750,554,150,38,12996
17077,"Illinois","JACKSON",11634,10843,1081,649,61,24268
17079,"Illinois","JASPER",924,3975,181,26,6,5112
17081,"Illinois","JEFFERSON",4425,11695,573,158,25,16876
17083,"Illinois","JERSEY",2679,7748,410,94,7,10938
17085,"Illinois","JODAVIESS",4462,6121,500,116,26,11225
17087,"Illinois","JOHNSON",1142,4649,182,57,13,6043
17089,"Illinois","KANE",103665,82734,9292,2896,727,199314
17091,"Illinois","KANKAKEE",18971,25129,1992,587,104,46783
17093,"Illinois","KENDALL",24884,24961,2675,742,185,53447
17095,"Illinois","KNOX",10083,10737,1109,278,36,22243
17097,"Illinois","LAKE",171095,109767,13312,3821,1045,299040
17099,"Illinois","LASALLE",19543,26689,2298,649,72,49251
17101,"Illinois","LAWRENCE",1290,4521,194,41,12,6058
17103,"Illinois","LEE",5528,8612,896,226,42,15304
17105,"Illinois","LIVINGSTON",4023,10208,777,125,73,15206
17107,"Illinois","LOGAN",3313,8181,537,130,96,12257
17109,"Illinois","MCDONOUGH",5288,6795,635,210,52,12980
17111,"Illinois","MCHENRY",60803,71612,7180,2155,540,142290
17113,"Illinois","MCLEAN",36196,37237,4855,1208,339,79835
17115,"Illinois","MACON",18343,26866,1851,459,89,47608
17117,"Illinois","MACOUPIN",6689,14322,934,247,31,22223
17119,"Illinois","MADISON",50587,70490,5472,1838,372,128759
17121,"Illinois","MARION",4369,11859,548,164,24,16964
17123,"Illinois","MARSHALL",1789,3785,266,78,21,5939
17125,"Illinois","MASON",2014,4058,321,54,7,6454
17127,"Illinois","MASSAC",1558,4846,194,42,14,6654
17129,"Illinois","MENARD",1817,4231,311,74,31,6464
17131,"Illinois","MERCER",3071,4807,475,82,12,8447
17133,"Illinois","MONROE",5535,12629,742,200,0,19106
17135,"Illinois","MONTGOMERY",3504,8630,599,128,17,12878
17137,"Illinois","MORGAN",4696,9076,670,189,14,14645
17139,"Illinois","MOULTRIE",1481,4455,238,44,13,6231
17141,"Illinois","OGLE",8050,14352,1159,275,33,23869
17143,"Illinois","PEORIA",38060,35633,3725,1085,599,79102
17145,"Illinois","PERRY",2462,6855,347,113,21,9798
17147,"Illinois","PIATT",2645,5634,558,83,52,8972
17149,"Illinois","PIKE",1413,5754,257,40,16,7480
17151,"Illinois","POPE",375,1678,62,18,3,2136
17153,"Illinois","PULASKI",962,1675,55,20,0,2712
17155,"Illinois","PUTNAM",1147,1767,136,35,1,3086
17157,"Illinois","RANDOLPH",3439,10023,490,135,12,14099
17159,"Illinois","RICHLAND",1584,5739,235,81,10,7649
17161,"Illinois","ROCK ISLAND",32298,26998,3015,733,127,63171
17163,"Illinois","ST. CLAIR",60756,53857,4181,1473,313,120580
17165,"Illinois","SALINE",2572,8276,358,77,13,11296
17167,"Illinois","SANGAMON",40907,49944,4512,1443,428,97234
17169,"Illinois","SCHUYLER",1075,2524,154,41,6,3800
17171,"Illinois","SCOTT",535,1966,68,22,6,2597
17173,"Illinois","SHELBY",2288,8229,372,55,39,10983
17175,"Illinois","STARK",751,1778,149,33,6,2717
17177,"Illinois","STEPHENSON",7768,11083,936,250,49,20086
17179,"Illinois","TAZEWELL",20685,38707,3358,830,351,63931
17181,"Illinois","UNION",2402,5790,219,126,14,8551
17183,"Illinois","VERMILION",10039,19087,1097,296,51,30570
17185,"Illinois","WABASH",1151,4047,175,42,13,5428
17187,"Illinois","WARREN",2987,4275,359,92,17,7730
17189,"Illinois","WASHINGTON",1448,5571,289,75,11,7394
17191,"Illinois","WAYNE",1048,6967,191,55,4,8265
17193,"Illinois","WHITE",1412,5640,205,34,5,7296
17195,"Illinois","WHITESIDE",11035,12615,1285,326,19,25280
17197,"Illinois","WILL",151927,132720,11822,3885,550,300904
17199,"Illinois","WILLIAMSON",8581,21570,997,396,79,31623
17201,"Illinois","WINNEBAGO",55713,55624,5064,1703,272,118376
17203,"Illinois","WOODFORD",5092,13207,942,214,177,19632
18001,"Indiana","Adams",2805,9648,595,23,19,13090
18003,"Indiana","Allen",55382,83930,6802,702,321,147137
18005,"Indiana","Bartholomew",9841,20640,1911,60,38,32490
18007,"Indiana","Benton",860,2579,215,9,3,3666
18009,"Indiana","Blackford",1243,3350,230,15,1,4839
18011,"Indiana","Boone",10181,19654,2226,75,42,32178
18013,"Indiana","Brown",2518,5016,375,31,5,7945
18015,"Indiana","Carroll",1892,6273,445,24,9,8643
18017,"Indiana","Cass",3759,9701,680,49,20,14209
18019,"Indiana","Clark",18808,30035,2304,0,0,51147
18021,"Indiana","Clay",2306,8531,426,11,8,11282
18023,"Indiana","Clinton",2819,8531,547,31,8,11936
18025,"Indiana","Crawford",1323,3015,255,0,0,4593
18027,"Indiana","Daviess",1800,8545,391,25,7,10768
18029,"Indiana","Dearborn",4883,18113,917,46,28,23987
18031,"Indiana","Decatur",2121,8490,487,17,12,11127
18033,"Indiana","DeKalb",3942,12054,821,61,24,16902
18035,"Indiana","Delaware",18153,24263,2388,252,67,45123
18037,"Indiana","Dubois",5389,13365,1163,45,22,19984
18039,"Indiana","Elkhart",20740,41867,2716,204,103,65630
18041,"Indiana","Fayette",2252,6839,439,0,0,9530
18043,"Indiana","Floyd",13945,21432,1861,157,30,37425
18045,"Indiana","Fountain",1476,5662,337,10,7,7492
18047,"Indiana","Franklin",1969,8669,358,15,2,11013
18049,"Indiana","Fulton",1960,6010,404,0,0,8374
18051,"Indiana","Gibson",3721,11081,673,9,0,15484
18053,"Indiana","Grant",7010,17008,1198,59,37,25312
18055,"Indiana","Greene",2929,10277,559,35,1,13801
18057,"Indiana","Hamilton",57263,87404,9122,299,168,154256
18059,"Indiana","Hancock",8904,25074,2077,89,37,36181
18061,"Indiana","Harrison",4783,12943,759,48,25,18558
18063,"Indiana","Hendricks",22600,48337,4338,205,79,75559
18065,"Indiana","Henry",5124,13895,1056,57,23,20155
18067,"Indiana","Howard",11215,23675,1864,60,29,36843
18069,"Indiana","Huntington",3506,11649,819,31,38,16043
18071,"Indiana","Jackson",3843,12859,832,30,9,17573
18073,"Indiana","Jasper",3329,9382,620,33,14,13378
18075,"Indiana","Jay",1889,5697,376,21,3,7986
18077,"Indiana","Jefferson",4326,8546,598,33,41,13544
18079,"Indiana","Jennings",2364,8224,529,16,17,11150
18081,"Indiana","Johnson",17318,45456,3455,211,60,66500
18083,"Indiana","Knox",3772,11077,634,26,7,15516
18085,"Indiana","Kosciusko",6313,23935,1687,60,89,32084
18087,"Indiana","LaGrange",2080,7025,447,7,7,9566
18089,"Indiana","Lake",116935,75625,7789,772,84,201205
18091,"Indiana","La Porte",19798,22687,2521,163,34,45203
18093,"Indiana","Lawrence",4210,14035,832,66,9,19152
18095,"Indiana","Madison",18595,32376,2689,207,42,53909
18097,"Indiana","Marion",212899,130360,18190,726,197,362372
18099,"Indiana","Marshall",4798,12288,924,44,28,18082
18101,"Indiana","Martin",881,3697,231,0,0,4809
18103,"Indiana","Miami",2766,9975,699,30,12,13482
18105,"Indiana","Monroe",34216,20592,2917,627,102,58454
18107,"Indiana","Montgomery",3362,11059,688,38,9,15156
18109,"Indiana","Morgan",6040,23674,1472,64,30,31280
18111,"Indiana","Newton",1404,4077,314,0,0,5795
18113,"Indiana","Noble",3904,12198,788,0,0,16890
18115,"Indiana","Ohio",686,2118,113,4,0,2921
18117,"Indiana","Orange",2048,5803,341,0,0,8192
18119,"Indiana","Owen",1946,6153,423,29,6,8557
18121,"Indiana","Parke",1441,4863,272,5,1,6582
18123,"Indiana","Perry",3062,4556,407,24,6,8055
18125,"Indiana","Pike",1297,4398,282,0,0,5977
18127,"Indiana","Porter",33676,38832,4253,367,62,77190
18129,"Indiana","Posey",3521,8404,542,0,0,12467
18131,"Indiana","Pulaski",1327,3854,256,13,9,5459
18133,"Indiana","Putnam",3356,10637,687,20,15,14715
18135,"Indiana","Randolph",2446,7517,495,0,0,10458
18137,"Indiana","Ripley",2471,9806,513,9,11,12810
18139,"Indiana","Rush",1525,5292,397,0,0,7214
18141,"Indiana","St. Joseph",52252,52021,5186,405,196,110060
18143,"Indiana","Scott",2642,6074,344,26,15,9101
18145,"Indiana","Shelby",4247,12718,970,43,16,17994
18147,"Indiana","Spencer",2861,6572,526,15,5,9979
18149,"Indiana","Starke",2489,6367,370,0,0,9226
18151,"Indiana","Steuben",3744,10133,662,18,9,14566
18153,"Indiana","Sullivan",2113,6138,308,0,0,8559
18155,"Indiana","Switzerland",930,2558,151,5,55,3699
18157,"Indiana","Tippecanoe",27282,30768,4002,339,124,62515
18159,"Indiana","Tipton",1587,5589,334,0,0,7510
18161,"Indiana","Union",715,2445,126,5,0,3291
18163,"Indiana","Vanderburgh",28530,40496,3263,191,27,72507
18165,"Indiana","Vermillion",2081,4513,321,17,7,6939
18167,"Indiana","Vigo",15931,21937,1723,190,37,39818
18169,"Indiana","Wabash",3018,9821,578,39,12,13468
18171,"Indiana","Warren",839,2898,184,5,4,3930
18173,"Indiana","Warrick",9086,19113,1390,0,0,29589
18175,"Indiana","Washington",2636,8209,491,32,14,11382
18177,"Indiana","Wayne",8322,16028,1225,2,2,25579
18179,"Indiana","Wells",2586,10005,539,28,27,13185
18181,"Indiana","White",2590,6893,530,24,16,10053
18183,"Indiana","Whitley",3379,11358,799,58,29,15623
19001,"Iowa","Adair",1133,2461,127,14,113,3848
19003,"Iowa","Adams",565,1395,93,9,69,2131
19005,"Iowa","Allamakee",2421,4093,227,46,248,7035
19007,"Iowa","Appanoose",1814,4033,139,42,168,6196
19009,"Iowa","Audubon",1080,2136,107,24,139,3486
19011,"Iowa","Benton",4678,8232,542,86,433,13971
19013,"Iowa","Black Hawk",32233,27476,2368,610,2320,65007
19015,"Iowa","Boone",5541,7484,643,104,538,14310
19017,"Iowa","Bremer",5356,7208,543,81,503,13691
19019,"Iowa","Buchanan",3970,5510,478,54,365,10377
19021,"Iowa","Buena Vista",2856,4903,288,48,286,8381
19023,"Iowa","Butler",2157,4921,219,43,243,7583
19025,"Iowa","Calhoun",1398,3468,173,18,161,5218
19027,"Iowa","Carroll",3309,6638,318,61,356,10682
19029,"Iowa","Cass",1951,4761,206,52,228,7198
19031,"Iowa","Cedar",3599,5295,365,70,302,9631
19033,"Iowa","Cerro Gordo",9862,11621,851,130,673,23137
19035,"Iowa","Cherokee",1679,4192,206,29,209,6315
19037,"Iowa","Chickasaw",2266,3742,236,48,226,6518
19039,"Iowa","Clarke",1465,2713,160,18,153,4509
19041,"Iowa","Clay",2249,5877,288,35,257,8706
19043,"Iowa","Clayton",3237,5317,334,51,278,9217
19045,"Iowa","Clinton",10095,11276,825,184,967,23347
19047,"Iowa","Crawford",1991,4617,172,33,224,7037
19049,"Iowa","Dallas",15701,19339,1757,181,1610,38588
19051,"Iowa","Davis",977,2723,85,25,133,3943
19053,"Iowa","Decatur",1201,2296,123,29,135,3784
19055,"Iowa","Delaware",2957,5694,337,40,311,9339
19057,"Iowa","Des Moines",8212,9529,635,134,761,19271
19059,"Iowa","Dickinson",3056,6753,292,54,302,10457
19061,"Iowa","Dubuque",22850,23460,2013,379,1519,50221
19063,"Iowa","Emmet",1357,3124,139,26,164,4810
19065,"Iowa","Fayette",3689,5620,328,62,399,10098
19067,"Iowa","Floyd",3179,4375,241,60,304,8159
19069,"Iowa","Franklin",1493,3163,188,31,171,5046
19071,"Iowa","Fremont",963,2407,115,21,127,3633
19073,"Iowa","Greene",1691,2820,160,31,174,4876
19075,"Iowa","Grundy",1856,4527,233,38,290,6944
19077,"Iowa","Guthrie",1732,3628,258,19,179,5816
19079,"Iowa","Hamilton",2726,4463,259,31,306,7785
19081,"Iowa","Hancock",1587,3977,166,24,179,5933
19083,"Iowa","Hardin",2787,5254,298,28,272,8639
19085,"Iowa","Harrison",2131,4902,210,50,259,7552
19087,"Iowa","Henry",2904,5779,337,113,367,9500
19089,"Iowa","Howard",1677,2611,131,38,183,4640
19091,"Iowa","Humboldt",1252,3568,127,20,174,5141
19093,"Iowa","Ida",792,2655,103,9,89,3648
19095,"Iowa","Iowa",3084,5205,317,61,335,9002
19097,"Iowa","Jackson",3837,5824,319,85,439,10504
19099,"Iowa","Jasper",7109,10560,715,95,747,19226
19101,"Iowa","Jefferson",3710,3748,246,256,325,8285
19103,"Iowa","Johnson",50200,21044,2758,878,2596,77476
19105,"Iowa","Jones",3787,5720,305,62,362,10236
19107,"Iowa","Keokuk",1342,3390,139,28,136,5035
19109,"Iowa","Kossuth",2543,5653,194,33,319,8742
19111,"Iowa","Lee",6215,8803,510,145,674,16347
19113,"Iowa","Linn",58935,48390,5557,1005,4229,118116
19115,"Iowa","Louisa",1648,3069,136,28,195,5076
19117,"Iowa","Lucas",1239,2877,115,28,133,4392
19119,"Iowa","Lyon",920,5192,137,18,164,6431
19121,"Iowa","Madison",2678,5360,347,41,280,8706
19123,"Iowa","Mahaska",2619,7432,318,38,316,10723
19125,"Iowa","Marion",5482,10962,706,73,768,17991
19127,"Iowa","Marshall",7652,9146,577,117,683,18175
19129,"Iowa","Mills",2090,5067,307,56,252,7772
19131,"Iowa","Mitchell",1888,3190,210,28,205,5521
19133,"Iowa","Monona",1247,3120,112,22,128,4629
19135,"Iowa","Monroe",1056,2638,104,13,96,3907
19137,"Iowa","Montgomery",1314,3436,152,38,162,5102
19139,"Iowa","Muscatine",8368,9584,748,183,740,19623
19141,"Iowa","O'Brien",1315,5752,197,28,168,7460
19143,"Iowa","Osceola",552,2531,73,10,85,3251
19145,"Iowa","Page",1807,4893,176,37,208,7121
19147,"Iowa","Palo Alto",1398,3081,131,20,130,4760
19149,"Iowa","Plymouth",2885,9680,343,52,314,13274
19151,"Iowa","Pocahontas",963,2702,115,14,124,3918
19153,"Iowa","Polk",119804,93492,10029,1737,8323,233385
19155,"Iowa","Pottawattamif",15355,24447,1469,327,1460,43058
19157,"Iowa","Poweshiek",4304,4946,283,73,310,9916
19159,"Iowa","Ringgold",753,1824,72,8,95,2752
19161,"Iowa","Sac",1270,3703,129,23,132,5257
19163,"Iowa","Scott",40440,39149,3555,784,3358,87286
19165,"Iowa","Shelby",1662,4362,174,28,222,6448
19167,"Iowa","Sioux",2300,14785,435,53,759,18332
19169,"Iowa","Story",25709,19458,3014,491,2302,50974
19171,"Iowa","Tama",3196,4971,245,79,375,8866
19173,"Iowa","Taylor",758,2111,97,10,89,3065
19175,"Iowa","Union",1922,3525,213,52,173,5885
19177,"Iowa","Van Buren",845,2527,83,19,121,3595
19179,"Iowa","Wapello",5594,8715,380,122,466,15277
19181,"Iowa","Warren",10411,14814,1275,123,884,27507
19183,"Iowa","Washington",3943,6173,459,79,438,11092
19185,"Iowa","Wayne",719,2069,78,17,106,2989
19187,"Iowa","Webster",6305,10056,569,113,550,17593
19189,"Iowa","Winnebago",1931,3447,218,34,234,5864
19191,"Iowa","Winneshiek",5254,5344,382,99,432,11511
19193,"Iowa","Woodbury",16210,24727,1179,324,1727,44167
19195,"Iowa","Worth",1530,2453,165,24,133,4305
19197,"Iowa","Wright",1896,3800,176,35,185,6092
20001,"Kansas","ALLEN",1433,3651,229,121,20,5454
20003,"Kansas","ANDERSON",672,2435,151,81,11,3350
20005,"Kansas","ATCHISON",1989,4049,316,163,58,6575
20007,"Kansas","BARBER",286,1850,78,28,10,2252
20009,"Kansas","BARTON",1839,7888,347,157,37,10268
20011,"Kansas","BOURBON",1336,4424,205,108,20,6093
20013,"Kansas","BROWN",863,2906,158,97,12,4036
20015,"Kansas","BUTLER",6573,19073,1415,395,201,27657
20017,"Kansas","CHASE",316,969,45,31,8,1369
20019,"Kansas","CHAUTAUQUA",197,1236,25,23,NA,1481
20021,"Kansas","CHEROKEE",2005,6182,296,130,7,8620
20023,"Kansas","CHEYENNE",181,1173,29,20,4,1407
20025,"Kansas","CLARK",120,825,36,20,4,1005
20027,"Kansas","CLAY",677,2891,150,85,17,3820
20029,"Kansas","CLOUD",761,2919,161,74,15,3930
20031,"Kansas","COFFEY",727,3050,189,70,32,4068
20033,"Kansas","COMANCHE",102,715,40,10,NA,867
20035,"Kansas","COWLEY",3551,8270,479,275,46,12621
20037,"Kansas","CRAWFORD",5199,8624,672,314,82,14891
20039,"Kansas","DECATUR",178,1210,42,20,2,1452
20041,"Kansas","DICKINSON",1609,6029,369,169,34,8210
20043,"Kansas","DONIPHAN",587,2606,125,56,4,3378
20045,"Kansas","DOUGLAS",31195,14688,2429,1555,220,50087
20047,"Kansas","EDWARDS",212,1037,33,34,3,1319
20049,"Kansas","ELK",160,1048,35,16,NA,1259
20051,"Kansas","ELLIS",2742,8466,464,237,38,11947
20053,"Kansas","ELLSWORTH",521,1969,107,74,8,2679
20055,"Kansas","FINNEY",3195,6350,424,180,10,10159
20057,"Kansas","FORD",2149,5114,281,136,38,7718
20059,"Kansas","FRANKLIN",2892,7185,568,265,55,10965
20061,"Kansas","GEARY",2722,4274,312,156,40,7504
20063,"Kansas","GOVE",149,1140,41,13,NA,1343
20065,"Kansas","GRAHAM",188,1025,38,30,3,1284
20067,"Kansas","GRANT",441,1804,101,33,10,2389
20069,"Kansas","GRAY",263,1698,75,30,NA,2066
20071,"Kansas","GREELEY",83,534,25,8,NA,650
20073,"Kansas","GREENWOOD",485,2160,122,59,14,2840
20075,"Kansas","HAMILTON",121,705,31,14,5,876
20077,"Kansas","HARPER",393,1996,117,60,12,2578
20079,"Kansas","HARVEY",5068,8668,684,370,126,14916
20081,"Kansas","HASKELL",245,1040,41,22,6,1354
20083,"Kansas","HODGEMAN",124,855,21,17,NA,1017
20085,"Kansas","JACKSON",1512,3939,213,143,11,5818
20087,"Kansas","JEFFERSON",2518,5213,384,185,37,8337
20089,"Kansas","JEWELL",180,1223,48,41,2,1494
20091,"Kansas","JOHNSON",129852,137490,15156,5022,2570,290090
20093,"Kansas","KEARNY",174,1075,41,13,13,1316
20095,"Kansas","KINGMAN",599,2530,114,69,22,3334
20097,"Kansas","KIOWA",114,900,44,16,5,1079
20099,"Kansas","LABETTE",2291,5335,298,166,17,8107
20101,"Kansas","LANE",106,718,33,14,NA,871
20103,"Kansas","LEAVENWORTH",10209,17638,1611,662,181,30301
20105,"Kansas","LINCOLN",215,1179,41,29,NA,1464
20107,"Kansas","LINN",736,3484,119,65,23,4427
20109,"Kansas","LOGAN",149,1132,47,28,1,1357
20111,"Kansas","LYON",4649,6552,670,331,86,12288
20113,"Kansas","MCPHERSON",3226,8549,574,295,98,12742
20115,"Kansas","MARION",1204,4003,227,143,47,5624
20117,"Kansas","MARSHALL",1072,3307,204,73,17,4673
20119,"Kansas","MEADE",210,1415,62,18,15,1720
20121,"Kansas","MIAMI",3991,10003,683,259,86,15022
20123,"Kansas","MITCHELL",477,2308,89,55,13,2942
20125,"Kansas","MONTGOMERY",2637,8679,407,210,71,12004
20127,"Kansas","MORRIS",601,1820,138,62,3,2624
20129,"Kansas","MORTON",147,995,33,14,3,1192
20131,"Kansas","NEMAHA",725,4124,164,82,27,5122
20133,"Kansas","NEOSHO",1501,4431,240,120,22,6314
20135,"Kansas","NESS",162,1228,42,21,1,1454
20137,"Kansas","NORTON",281,1840,67,41,5,2234
20139,"Kansas","OSAGE",1753,4826,302,165,NA,7046
20141,"Kansas","OSBORNE",233,1460,46,41,8,1788
20143,"Kansas","OTTAWA",424,2283,144,42,10,2903
20145,"Kansas","PAWNEE",579,1904,131,34,13,2661
20147,"Kansas","PHILLIPS",300,2233,87,29,15,2664
20149,"Kansas","POTTAWATOMIE",2225,7612,543,193,120,10693
20151,"Kansas","PRATT",771,2838,164,50,19,3842
20153,"Kansas","RAWLINS",163,1220,55,26,8,1472
20155,"Kansas","RENO",6837,15513,1280,456,124,24210
20157,"Kansas","REPUBLIC",375,2024,83,43,4,2529
20159,"Kansas","RICE",695,2837,194,69,9,3804
20161,"Kansas","RILEY",9341,10107,1468,399,217,21532
20163,"Kansas","ROOKS",275,2031,80,29,4,2419
20165,"Kansas","RUSH",233,1197,55,18,NA,1503
20167,"Kansas","RUSSELL",461,2574,111,44,3,3193
20169,"Kansas","SALINE",6317,13828,1378,461,80,22064
20171,"Kansas","SCOTT",236,1865,69,27,5,2202
20173,"Kansas","SEDGWICK",69627,104353,9214,4042,1547,188783
20175,"Kansas","SEWARD",1628,3159,186,58,7,5038
20177,"Kansas","SHAWNEE",33926,35934,3412,1752,382,75406
20179,"Kansas","SHERIDAN",127,1197,38,12,NA,1374
20181,"Kansas","SHERMAN",347,2089,111,47,18,2612
20183,"Kansas","SMITH",297,1661,55,29,NA,2042
20185,"Kansas","STAFFORD",304,1490,62,34,6,1896
20187,"Kansas","STANTON",115,492,19,7,4,637
20189,"Kansas","STEVENS",220,1599,49,23,NA,1891
20191,"Kansas","SUMNER",2076,6984,420,205,37,9722
20193,"Kansas","THOMAS",473,2908,131,56,8,3576
20195,"Kansas","TREGO",198,1227,40,17,NA,1482
20197,"Kansas","WABAUNSEE",776,2372,143,69,20,3380
20199,"Kansas","WALLACE",46,721,15,8,8,798
20201,"Kansas","WASHINGTON",387,2194,124,45,15,2765
20203,"Kansas","WICHITA",140,769,18,12,17,956
20205,"Kansas","WILSON",594,2788,135,60,14,3591
20207,"Kansas","WOODSON",273,1082,64,24,NA,1443
20209,"Kansas","WYANDOTTE",30146,15806,1725,947,157,48781
21001,"Kentucky","Adair",1323,6637,141,35,97,8233
21003,"Kentucky","Allen",1349,6466,161,46,74,8096
21005,"Kentucky","Anderson",2634,8242,319,54,173,11422
21007,"Kentucky","Ballard",816,3161,77,20,27,4101
21009,"Kentucky","Barren",4275,13483,455,93,182,18488
21011,"Kentucky","Bath",1361,3082,75,24,45,4587
21013,"Kentucky","Bell",1720,7764,144,42,48,9718
21015,"Kentucky","Boone",15026,39082,2299,380,831,57618
21017,"Kentucky","Bourbon",2791,5569,283,52,108,8803
21019,"Kentucky","Boyd",6021,13591,496,167,179,20454
21021,"Kentucky","Boyle",4281,8040,365,73,187,12946
21023,"Kentucky","Bracken",705,2711,51,20,40,3527
21025,"Kentucky","Breathitt",1537,3991,117,35,58,5738
21027,"Kentucky","Breckinridge",1960,6484,194,47,89,8774
21029,"Kentucky","Bullitt",8255,26210,964,253,387,36069
21031,"Kentucky","Butler",947,4428,136,11,54,5576
21033,"Kentucky","Caldwell",1260,4507,118,32,58,5975
21035,"Kentucky","Calloway",4749,10367,492,150,291,16049
21037,"Kentucky","Campbell",14658,25050,1789,422,591,42510
21039,"Kentucky","Carlisle",432,2094,42,12,21,2601
21041,"Kentucky","Carroll",1106,2588,100,24,37,3855
21043,"Kentucky","Carter",2276,7587,237,58,120,10278
21045,"Kentucky","Casey",767,5482,121,28,41,6439
21047,"Kentucky","Christian",7188,14108,474,120,193,22083
21049,"Kentucky","Clark",4706,10710,453,121,215,16205
21051,"Kentucky","Clay",752,5861,83,26,45,6767
21053,"Kentucky","Clinton",547,3809,60,15,31,4462
21055,"Kentucky","Crittenden",617,3290,76,17,37,4037
21057,"Kentucky","Cumberland",459,2502,67,11,27,3066
21059,"Kentucky","Daviess",14163,28907,1488,453,796,45807
21061,"Kentucky","Edmonson",979,4135,77,20,33,5244
21063,"Kentucky","Elliott",740,2000,67,19,29,2855
21065,"Kentucky","Estill",1108,4236,129,30,42,5545
21067,"Kentucky","Fayette",69778,56894,5230,1580,2833,136315
21069,"Kentucky","Fleming",1348,4722,109,20,61,6260
21071,"Kentucky","Floyd",4015,11993,357,56,119,16540
21073,"Kentucky","Franklin",10717,11819,725,236,368,23865
21075,"Kentucky","Fulton",774,1549,35,7,17,2382
21077,"Kentucky","Gallatin",749,2443,100,18,28,3338
21079,"Kentucky","Garrard",1453,5904,157,33,76,7623
21081,"Kentucky","Grant",1910,7268,226,71,84,9559
21083,"Kentucky","Graves",3308,12671,411,80,136,16606
21085,"Kentucky","Grayson",1959,8219,259,46,93,10576
21087,"Kentucky","Green",832,4372,84,24,21,5333
21089,"Kentucky","Greenup",4146,11546,319,109,157,16277
21091,"Kentucky","Hancock",1244,2788,129,44,90,4295
21093,"Kentucky","Hardin",13944,26971,1413,346,482,43156
21095,"Kentucky","Harlan",1372,9129,156,39,61,10757
21097,"Kentucky","Harrison",2031,5435,184,46,85,7781
21099,"Kentucky","Hart",1730,5320,140,39,35,7264
21101,"Kentucky","Henderson",6707,12159,507,142,195,19710
21103,"Kentucky","Henry",1828,4944,224,58,95,7149
21105,"Kentucky","Hickman",449,1657,26,6,19,2157
21107,"Kentucky","Hopkins",4310,15277,478,97,183,20345
21109,"Kentucky","Jackson",482,4889,79,20,31,5501
21111,"Kentucky","Jefferson",190836,143768,10188,3224,5083,353099
21113,"Kentucky","Jessamine",6144,15474,829,170,709,23326
21115,"Kentucky","Johnson",1250,8043,163,60,56,9572
21117,"Kentucky","Kenton",24214,42958,3093,703,1030,71998
21119,"Kentucky","Knott",1245,4357,102,13,46,5763
21121,"Kentucky","Knox",1761,9885,189,64,113,12012
21123,"Kentucky","Larue",1278,4799,174,28,88,6367
21125,"Kentucky","Laurel",3440,20592,473,114,214,24833
21127,"Kentucky","Lawrence",1045,4816,107,32,42,6042
21129,"Kentucky","Lee",444,2151,42,7,23,2667
21131,"Kentucky","Leslie",400,4015,39,15,23,4492
21133,"Kentucky","Letcher",1542,7293,210,37,52,9134
21135,"Kentucky","Lewis",785,4363,95,16,39,5298
21137,"Kentucky","Lincoln",1865,7338,226,44,88,9561
21139,"Kentucky","Livingston",887,3570,115,24,49,4645
21141,"Kentucky","Logan",2755,7778,229,43,94,10899
21143,"Kentucky","Lyon",1045,2789,74,15,39,3962
21145,"Kentucky","McCracken",9134,20774,839,217,343,31307
21147,"Kentucky","McCreary",664,5012,59,18,23,5776
21149,"Kentucky","McLean",988,3381,137,15,45,4566
21151,"Kentucky","Madison",11793,23431,1189,353,605,37371
21153,"Kentucky","Magoffin",1172,3824,66,17,37,5116
21155,"Kentucky","Marion",2679,5122,215,33,62,8111
21157,"Kentucky","Marshall",3672,12322,426,84,194,16698
21159,"Kentucky","Martin",363,3503,52,13,22,3953
21161,"Kentucky","Mason",1970,4944,173,38,94,7219
21163,"Kentucky","Meade",3026,8660,333,97,115,12231
21165,"Kentucky","Menifee",700,2010,43,14,12,2779
21167,"Kentucky","Mercer",2395,7740,275,68,107,10585
21169,"Kentucky","Metcalfe",976,3491,86,22,45,4620
21171,"Kentucky","Monroe",601,4278,76,13,23,4991
21173,"Kentucky","Montgomery",3158,7856,264,68,106,11452
21175,"Kentucky","Morgan",1006,3628,63,26,52,4775
21177,"Kentucky","Muhlenberg",3272,9393,230,44,121,13060
21179,"Kentucky","Nelson",6434,13431,565,131,241,20802
21181,"Kentucky","Nicholas",787,1957,65,9,23,2841
21183,"Kentucky","Ohio",2080,7942,207,64,105,10398
21185,"Kentucky","Oldham",10268,20469,1229,282,605,32853
21187,"Kentucky","Owen",1062,3745,122,25,47,5001
21189,"Kentucky","Owsley",256,1474,24,0,5,1759
21191,"Kentucky","Pendleton",1164,4604,145,27,67,6007
21193,"Kentucky","Perry",2136,8158,168,47,63,10572
21195,"Kentucky","Pike",4280,19747,413,86,139,24665
21197,"Kentucky","Powell",1272,3513,118,27,27,4957
21199,"Kentucky","Pulaski",4208,22902,562,127,242,28041
21201,"Kentucky","Robertson",222,759,19,5,8,1013
21203,"Kentucky","Rockcastle",915,5609,87,25,55,6691
21205,"Kentucky","Rowan",3295,5174,207,85,87,8848
21207,"Kentucky","Russell",1093,6863,153,14,51,8174
21209,"Kentucky","Scott",7715,15052,853,139,441,24200
21211,"Kentucky","Shelby",6276,13196,629,138,341,20580
21213,"Kentucky","Simpson",2144,5077,200,38,72,7531
21215,"Kentucky","Spencer",1921,7196,237,44,117,9515
21217,"Kentucky","Taylor",2553,8320,233,53,147,11306
21219,"Kentucky","Todd",1042,3612,64,26,35,4779
21221,"Kentucky","Trigg",1587,4931,121,45,67,6751
21223,"Kentucky","Trimble",879,2771,88,20,40,3798
21225,"Kentucky","Union",1331,4701,115,29,35,6211
21227,"Kentucky","Warren",16966,28673,1605,415,795,48454
21229,"Kentucky","Washington",1420,4013,111,17,75,5636
21231,"Kentucky","Wayne",1431,6371,116,30,44,7992
21233,"Kentucky","Webster",1240,4397,111,22,35,5805
21235,"Kentucky","Whitley",2067,11312,242,41,112,13774
21237,"Kentucky","Wolfe",753,1804,42,9,27,2635
21239,"Kentucky","Woodford",4958,7697,529,117,262,13563
22001,"Louisiana","Acadia",5638,21162,281,106,202,27389
22003,"Louisiana","Allen",2106,6867,102,50,120,9245
22005,"Louisiana","Ascension",16476,36143,1184,324,551,54678
22007,"Louisiana","Assumption",3931,6714,127,39,93,10904
22009,"Louisiana","Avoyelles",5035,11165,188,69,129,16586
22011,"Louisiana","Beauregard",2393,12238,225,64,158,15078
22013,"Louisiana","Bienville",3129,3756,54,23,43,7005
22015,"Louisiana","Bossier",12641,35474,1024,263,446,49848
22017,"Louisiana","Caddo",53483,49006,1861,665,789,105804
22019,"Louisiana","Calcasieu",26296,54191,1786,551,961,83785
22021,"Louisiana","Caldwell",788,3822,28,14,40,4692
22023,"Louisiana","Cameron",323,3256,57,16,40,3692
22025,"Louisiana","Catahoula",1322,3479,17,14,24,4856
22027,"Louisiana","Claiborne",2717,3585,45,25,49,6421
22029,"Louisiana","Concordia",3272,5477,68,14,41,8872
22031,"Louisiana","De Soto",5165,8068,128,33,106,13500
22033,"Louisiana","East Baton Rouge",102828,84660,4959,1643,2401,196491
22035,"Louisiana","East Carroll",1838,1059,16,6,20,2939
22037,"Louisiana","East Feliciana",4235,5569,102,38,98,10042
22039,"Louisiana","Evangeline",4208,10360,116,66,132,14882
22041,"Louisiana","Franklin",2506,6514,68,28,46,9162
22043,"Louisiana","Grant",1181,7408,126,34,72,8821
22045,"Louisiana","Iberia",10698,20903,443,170,240,32454
22047,"Louisiana","Iberville",8324,7320,165,92,142,16043
22049,"Louisiana","Jackson",2139,5169,74,20,62,7464
22051,"Louisiana","Jefferson",73670,100398,4306,1611,1654,181639
22053,"Louisiana","Jefferson Davis",3080,10775,185,71,166,14277
22055,"Louisiana","Lafayette",32726,68195,2833,851,998,105603
22057,"Louisiana","Lafourche",8423,31959,734,233,296,41645
22059,"Louisiana","Lasalle",605,5836,53,19,56,6569
22061,"Louisiana","Lincoln",7107,10761,440,120,241,18669
22063,"Louisiana","Livingston",6950,48824,1151,292,513,57730
22065,"Louisiana","Madison",2744,1927,17,15,29,4732
22067,"Louisiana","Morehouse",5155,6502,73,46,76,11852
22069,"Louisiana","Natchitoches",7144,8968,260,91,158,16621
22071,"Louisiana","Orleans",133996,24292,3638,2546,1340,165812
22073,"Louisiana","Ouachita",24428,41734,980,343,532,68017
22075,"Louisiana","Plaquemines",3347,6900,179,74,73,10573
22077,"Louisiana","Pointe Coupee",4764,6789,86,35,87,11761
22079,"Louisiana","Rapides",18322,36816,858,314,534,56844
22081,"Louisiana","Red River",1938,2391,47,11,35,4422
22083,"Louisiana","Richland",3157,6287,67,35,51,9597
22085,"Louisiana","Sabine",1703,7879,97,24,84,9787
22087,"Louisiana","St. Bernard",4960,10237,308,169,141,15815
22089,"Louisiana","St. Charles",8559,16621,592,186,234,26192
22091,"Louisiana","St. Helena",3353,2497,43,18,53,5964
22093,"Louisiana","St. James",6418,5456,98,44,69,12085
22095,"Louisiana","St. John The Baptist",12661,7569,228,122,163,20743
22097,"Louisiana","St. Landry",17209,21971,350,181,266,39977
22099,"Louisiana","St. Martin",8266,16873,303,121,187,25750
22101,"Louisiana","St. Mary",8050,14359,245,85,138,22877
22103,"Louisiana","St. Tammany",27717,90915,3409,1019,1332,124392
22105,"Louisiana","Tangipahoa",16878,33959,843,286,450,52416
22107,"Louisiana","Tensas",1332,1182,13,8,13,2548
22109,"Louisiana","Terrebonne",10665,31902,808,215,306,43896
22111,"Louisiana","Union",2691,7972,108,32,91,10894
22113,"Louisiana","Vermilion",4857,20063,396,116,200,25632
22115,"Louisiana","Vernon",2665,13471,265,72,160,16633
22117,"Louisiana","Washington",5692,12556,185,68,127,18628
22119,"Louisiana","Webster",6260,11542,166,63,114,18145
22121,"Louisiana","West Baton Rouge",5383,6927,206,72,124,12712
22123,"Louisiana","West Carroll",715,3970,27,10,37,4759
22125,"Louisiana","West Feliciana",2248,3390,97,17,47,5799
22127,"Louisiana","Winn",1644,4608,40,29,51,6372
23001,"Maine","AUBURN",5296,5325,737,207,421,11986
23001,"Maine","DURHAM",1084,1266,147,43,71,2611
23001,"Maine","GREENE",810,1542,150,26,69,2597
23001,"Maine","LEEDS",414,751,75,17,42,1299
23001,"Maine","LEWISTON",8222,7336,944,236,519,17257
23001,"Maine","LISBON",1697,2749,281,83,136,4946
23001,"Maine","LIVERMORE",471,704,64,22,78,1339
23001,"Maine","LIVERMORE FALLS",550,728,114,43,51,1486
23001,"Maine","MECHANIC FALLS",515,871,117,24,59,1586
23001,"Maine","MINOT",539,981,100,22,41,1683
23001,"Maine","POLAND",1244,1685,199,58,98,3284
23001,"Maine","SABATTUS",865,1701,152,50,82,2850
23001,"Maine","TURNER",1083,2010,149,46,95,3383
23001,"Maine","WALES",219,578,64,6,24,891
23003,"Maine","ALLAGASH",69,85,3,2,10,169
23003,"Maine","AMITY",29,82,4,2,7,124
23003,"Maine","ASHLAND",208,347,40,11,22,628
23003,"Maine","BLAINE",94,283,13,2,7,399
23003,"Maine","BRIDGEWATER",85,202,17,5,4,313
23003,"Maine","CARIBOU",1595,2106,213,45,130,4089
23003,"Maine","CARY PLT",24,81,6,1,6,118
23003,"Maine","CASTLE HILL",85,123,11,3,12,234
23003,"Maine","CASWELL",73,58,6,4,8,149
23003,"Maine","CHAPMAN",99,156,15,5,4,279
23003,"Maine","CRYSTAL",33,102,8,3,3,149
23003,"Maine","CYR PLT",22,28,1,0,2,53
23003,"Maine","DYER BROOK",38,96,9,4,3,150
23003,"Maine","EAGLE LAKE",218,231,16,3,15,483
23003,"Maine","EASTON",217,408,28,15,21,689
23003,"Maine","FORT FAIRFIELD",659,888,70,13,74,1704
23003,"Maine","FORT KENT",986,997,95,30,79,2187
23003,"Maine","FRENCHVILLE",264,312,22,8,20,626
23003,"Maine","GARFIELD PLT",14,31,4,1,3,53
23003,"Maine","GLENWOOD PLT",0,2,0,0,0,2
23003,"Maine","GRAND ISLE",122,93,4,4,10,233
23003,"Maine","HAMLIN",48,52,0,1,3,104
23003,"Maine","HAMMOND",8,37,3,1,1,50
23003,"Maine","HAYNESVILLE",11,33,2,1,3,50
23003,"Maine","HERSEY",4,23,5,0,2,34
23003,"Maine","HODGDON",148,499,22,6,15,690
23003,"Maine","HOULTON",940,1573,134,36,89,2772
23003,"Maine","ISLAND FALLS",123,249,16,11,20,419
23003,"Maine","LIMESTONE",325,410,37,15,25,812
23003,"Maine","LINNEUS",88,358,17,3,16,482
23003,"Maine","LITTLETON",112,356,19,7,15,509
23003,"Maine","LUDLOW",65,140,19,4,6,234
23003,"Maine","MACWAHOC PLT",14,27,2,0,1,44
23003,"Maine","MADAWASKA",1178,845,94,36,93,2246
23003,"Maine","MAPLETON",359,693,57,13,33,1155
23003,"Maine","MARS HILL",193,518,28,8,35,782
23003,"Maine","MASARDIS",44,79,3,2,2,130
23003,"Maine","MERRILL",37,82,11,3,4,137
23003,"Maine","MONTICELLO",96,296,8,6,19,425
23003,"Maine","MORO PLT",1,25,0,0,1,27
23003,"Maine","NASHVILLE PLT",7,12,1,0,0,20
23003,"Maine","NEW CANADA",68,85,4,4,3,164
23003,"Maine","NEW LIMERICK",97,224,11,2,13,347
23003,"Maine","NEW SWEDEN",147,185,24,8,13,377
23003,"Maine","OAKFIELD",102,254,16,7,13,392
23003,"Maine","ORIENT",13,69,1,1,5,89
23003,"Maine","OXBOW PLT",10,25,1,1,1,38
23003,"Maine","PERHAM",60,119,9,7,12,207
23003,"Maine","PORTAGE LAKE",88,153,6,3,10,260
23003,"Maine","PRESQUE ISLE",1779,2102,281,78,185,4425
23003,"Maine","REED PLT",14,61,0,3,1,79
23003,"Maine","SAINT AGATHA",258,279,28,6,15,586
23003,"Maine","SAINT FRANCIS",127,96,10,3,10,246
23003,"Maine","SAINT JOHN PLT",58,92,9,3,5,167
23003,"Maine","SHERMAN",141,467,20,6,13,647
23003,"Maine","SMYRNA",38,99,4,4,8,153
23003,"Maine","STOCKHOLM",67,53,7,25,5,157
23003,"Maine","VAN BUREN",501,391,27,11,34,964
23003,"Maine","WADE",41,86,11,4,4,146
23003,"Maine","WALLAGRASS",154,127,9,1,10,301
23003,"Maine","WASHBURN",284,482,45,7,46,864
23003,"Maine","WESTFIELD",85,146,13,1,13,258
23003,"Maine","WESTMANLAND",24,24,0,1,0,49
23003,"Maine","WESTON",55,121,1,3,5,185
23003,"Maine","WINTERVILLE PLT",53,73,5,2,5,138
23003,"Maine","WOODLAND",231,392,33,6,24,686
23005,"Maine","BALDWIN",271,560,58,16,31,936
23005,"Maine","BRIDGTON",1224,1474,158,69,102,3027
23005,"Maine","BRUNSWICK",7992,3647,579,236,438,12892
23005,"Maine","CAPE ELIZABETH",4480,1593,229,70,226,6598
23005,"Maine","CASCO",819,1117,104,46,69,2155
23005,"Maine","CUMBERLAND",3184,1755,283,55,228,5505
23005,"Maine","FALMOUTH",4877,2633,305,107,257,8179
23005,"Maine","FREEPORT",3442,1644,265,86,178,5615
23005,"Maine","FRYE ISLAND",43,26,8,0,1,78
23005,"Maine","GORHAM",4995,3945,486,161,360,9947
23005,"Maine","GRAY",2021,2397,269,81,163,4931
23005,"Maine","HARPSWELL",1881,1316,128,51,107,3483
23005,"Maine","HARRISON",568,760,80,38,51,1497
23005,"Maine","LONG ISLAND",109,52,7,2,6,176
23005,"Maine","NAPLES",826,1277,118,39,73,2333
23005,"Maine","NEW GLOUCESTER",1350,1657,167,61,129,3364
23005,"Maine","NORTH YARMOUTH",1493,922,118,35,88,2656
23005,"Maine","PORTLAND",28534,6789,1226,987,1041,38577
23005,"Maine","POWNAL",556,421,60,16,35,1088
23005,"Maine","RAYMOND",1263,1381,93,74,87,2898
23005,"Maine","SCARBOROUGH",6893,4918,533,191,459,12994
23005,"Maine","SEBAGO",421,600,64,20,27,1132
23005,"Maine","SOUTH PORTLAND",9919,3950,526,291,419,15105
23005,"Maine","STANDISH",2144,2873,280,80,178,5555
23005,"Maine","WESTBROOK",5431,3573,493,200,323,10020
23005,"Maine","WINDHAM",4308,4860,517,169,286,10140
23005,"Maine","YARMOUTH",3705,1503,236,71,210,5725
23007,"Maine","AVON",76,146,15,4,7,248
23007,"Maine","CARRABASSETT VALLEY",264,127,32,23,28,474
23007,"Maine","CARTHAGE",90,139,20,33,10,292
23007,"Maine","CHESTERVILLE",276,375,60,15,21,747
23007,"Maine","COPLIN PLT",38,44,11,3,7,103
23007,"Maine","DALLAS PLT",90,92,15,4,6,207
23007,"Maine","EUSTIS",136,222,37,12,18,425
23007,"Maine","FARMINGTON",1979,1483,260,104,157,3983
23007,"Maine","INDUSTRY",189,234,28,8,11,470
23007,"Maine","JAY",1143,1184,142,28,103,2600
23007,"Maine","KINGFIELD",297,403,65,18,27,810
23007,"Maine","NEW SHARON",310,498,69,31,34,942
23007,"Maine","NEW VINEYARD",130,256,29,7,28,450
23007,"Maine","PHILLIPS",230,344,34,14,27,649
23007,"Maine","RANGELEY",287,384,37,11,24,743
23007,"Maine","RANGELEY PLT",51,97,5,3,6,162
23007,"Maine","SANDY RIVER PLT",45,40,1,5,2,93
23007,"Maine","STRONG",225,460,54,13,28,780
23007,"Maine","TEMPLE",154,146,15,6,7,328
23007,"Maine","WELD",109,148,17,1,13,288
23007,"Maine","WILTON",872,1066,155,30,105,2228
23009,"Maine","AMHERST",57,99,7,6,5,174
23009,"Maine","AURORA",17,48,5,3,3,76
23009,"Maine","BAR HARBOR",2244,712,107,58,96,3217
23009,"Maine","BLUE HILL",1088,560,82,44,50,1824
23009,"Maine","BROOKLIN",346,177,20,16,15,574
23009,"Maine","BROOKSVILLE",406,190,15,21,25,657
23009,"Maine","BUCKSPORT",1035,1335,148,47,90,2655
23009,"Maine","CASTINE",329,205,37,8,21,600
23009,"Maine","CRANBERRY ISLES",100,41,6,4,2,153
23009,"Maine","DEDHAM",450,542,57,20,31,1100
23009,"Maine","DEER ISLE",684,453,43,21,29,1230
23009,"Maine","EASTBROOK",66,150,16,6,6,244
23009,"Maine","ELLSWORTH",1810,2113,242,90,146,4401
23009,"Maine","FRANKLIN",303,426,48,11,23,811
23009,"Maine","FRENCHBORO",7,23,0,2,1,33
23009,"Maine","GOULDSBORO",409,559,39,11,16,1034
23009,"Maine","GREAT POND",15,22,3,1,0,41
23009,"Maine","HANCOCK",507,678,73,29,44,1331
23009,"Maine","LAMOINE",481,516,60,12,43,1112
23009,"Maine","MARIAVILLE",91,165,20,4,12,292
23009,"Maine","MOUNT DESERT",917,389,54,21,55,1436
23009,"Maine","ORLAND",623,651,72,31,25,1402
23009,"Maine","OSBORN",14,26,1,0,0,41
23009,"Maine","OTIS",137,260,25,3,24,449
23009,"Maine","PENOBSCOT",445,279,29,29,28,810
23009,"Maine","SEDGWICK",397,287,33,16,30,763
23009,"Maine","SORRENTO",99,87,11,4,9,210
23009,"Maine","SOUTHWEST HARBOR",646,400,31,15,43,1135
23009,"Maine","STONINGTON",350,214,19,14,14,611
23009,"Maine","SULLIVAN",285,300,51,14,27,677
23009,"Maine","SURRY",490,418,46,25,37,1016
23009,"Maine","SWANS ISLAND",102,122,13,8,9,254
23009,"Maine","TREMONT",477,381,44,19,22,943
23009,"Maine","TRENTON",398,396,42,15,27,878
23009,"Maine","VERONA ISLAND",122,164,19,2,7,314
23009,"Maine","WALTHAM",48,141,15,3,3,210
23009,"Maine","WINTER HARBOR",113,153,25,8,11,310
23011,"Maine","ALBION",329,716,65,27,38,1175
23011,"Maine","AUGUSTA",4396,3805,501,192,320,9214
23011,"Maine","BELGRADE",826,1062,89,18,54,2049
23011,"Maine","BENTON",544,842,101,20,59,1566
23011,"Maine","CHELSEA",520,860,63,26,58,1527
23011,"Maine","CHINA",919,1347,135,42,73,2516
23011,"Maine","CLINTON",521,1012,86,29,59,1707
23011,"Maine","FARMINGDALE",773,761,96,32,61,1723
23011,"Maine","FAYETTE",344,373,40,10,22,789
23011,"Maine","GARDINER",1446,1361,156,80,77,3120
23011,"Maine","HALLOWELL",1093,374,71,46,75,1659
23011,"Maine","LITCHFIELD",701,1156,109,43,76,2085
23011,"Maine","MANCHESTER",746,769,84,19,61,1679
23011,"Maine","MONMOUTH",865,1271,166,36,74,2412
23011,"Maine","MOUNT VERNON",458,475,63,27,41,1064
23011,"Maine","OAKLAND",1442,1715,232,64,143,3596
23011,"Maine","PITTSTON",577,936,101,29,80,1723
23011,"Maine","RANDOLPH",426,475,59,18,40,1018
23011,"Maine","READFIELD",793,710,84,29,50,1666
23011,"Maine","ROME",282,268,28,16,28,622
23011,"Maine","SIDNEY",939,1411,160,46,110,2666
23011,"Maine","VASSALBORO",904,1335,126,34,81,2480
23011,"Maine","VIENNA",157,195,25,8,11,396
23011,"Maine","WATERVILLE",4171,2424,412,152,274,7433
23011,"Maine","WAYNE",424,321,42,15,13,815
23011,"Maine","WEST GARDINER",792,1186,121,41,69,2209
23011,"Maine","WINDSOR",406,813,90,31,48,1388
23011,"Maine","WINSLOW",1825,2100,255,68,158,4406
23011,"Maine","WINTHROP",1683,1602,208,86,129,3708
23013,"Maine","APPLETON",393,396,41,16,28,874
23013,"Maine","CAMDEN",2430,802,80,60,131,3503
23013,"Maine","CUSHING",372,440,34,12,24,882
23013,"Maine","FRIENDSHIP",271,425,31,13,18,758
23013,"Maine","HOPE",537,418,44,20,29,1048
23013,"Maine","ISLE AU HAUT",38,15,3,7,3,66
23013,"Maine","MATINICUS ISLE PLT",33,18,0,0,2,53
23013,"Maine","NORTH HAVEN",189,67,18,11,16,301
23013,"Maine","OWLS HEAD",496,431,35,36,40,1038
23013,"Maine","ROCKLAND",2024,1209,147,105,165,3650
23013,"Maine","ROCKPORT",1381,740,107,35,99,2362
23013,"Maine","SAINT GEORGE",930,621,47,29,62,1689
23013,"Maine","SOUTH THOMASTON",445,383,46,13,39,926
23013,"Maine","THOMASTON",785,581,63,38,49,1516
23013,"Maine","UNION",582,665,59,27,36,1369
23013,"Maine","VINALHAVEN",448,249,34,32,24,787
23013,"Maine","WARREN",765,1181,109,45,53,2153
23013,"Maine","WASHINGTON",323,507,50,36,34,950
23013,"Maine","WASHINGTON TWP",7,9,1,0,0,17
23015,"Maine","ALNA",262,176,15,14,15,482
23015,"Maine","BOOTHBAY",980,899,112,40,82,2113
23015,"Maine","BOOTHBAY HARBOR",729,541,64,22,37,1393
23015,"Maine","BREMEN",282,194,11,6,20,513
23015,"Maine","BRISTOL",936,767,73,35,83,1894
23015,"Maine","DAMARISCOTTA",767,454,70,23,58,1372
23015,"Maine","DRESDEN",447,513,63,20,46,1089
23015,"Maine","EDGECOMB",422,321,47,14,19,823
23015,"Maine","JEFFERSON",548,874,88,40,63,1613
23015,"Maine","MONHEGAN ISLAND PLT",40,6,2,9,3,60
23015,"Maine","NEWCASTLE",786,380,43,15,46,1270
23015,"Maine","NOBLEBORO",548,518,45,26,39,1176
23015,"Maine","SOMERVILLE",101,197,29,8,11,346
23015,"Maine","SOUTH BRISTOL",332,229,40,13,16,630
23015,"Maine","SOUTHPORT",218,179,18,5,11,431
23015,"Maine","WALDOBORO",1133,1409,123,46,123,2834
23015,"Maine","WESTPORT ISLAND",241,219,29,12,15,516
23015,"Maine","WHITEFIELD",605,687,62,38,39,1431
23015,"Maine","WISCASSET",864,1164,105,39,79,2251
23017,"Maine","ANDOVER",195,280,40,13,18,546
23017,"Maine","BETHEL",856,678,102,20,56,1712
23017,"Maine","BROWNFIELD",366,428,42,11,31,878
23017,"Maine","BUCKFIELD",371,619,58,19,45,1112
23017,"Maine","BYRON",29,52,3,5,4,93
23017,"Maine","CANTON",152,242,37,76,32,539
23017,"Maine","DENMARK",285,382,40,21,24,752
23017,"Maine","DIXFIELD",415,709,90,24,68,1306
23017,"Maine","FRYEBURG",810,768,134,38,83,1833
23017,"Maine","GILEAD",42,62,10,2,2,118
23017,"Maine","GREENWOOD",213,211,27,7,16,474
23017,"Maine","HANOVER",84,85,11,5,4,189
23017,"Maine","HARTFORD",206,378,43,10,18,655
23017,"Maine","HEBRON",249,397,74,10,23,753
23017,"Maine","HIRAM",312,442,49,19,35,857
23017,"Maine","LINCOLN PLT",8,17,1,0,3,29
23017,"Maine","LOVELL",313,335,44,8,16,716
23017,"Maine","MAGALLOWAY PLT",2,15,0,0,1,18
23017,"Maine","MEXICO",544,647,85,28,58,1362
23017,"Maine","NEWRY",136,109,14,10,13,282
23017,"Maine","NORWAY",1056,1313,152,36,136,2693
23017,"Maine","OTISFIELD",423,560,60,22,29,1094
23017,"Maine","OXFORD",694,1270,150,39,77,2230
23017,"Maine","PARIS",1034,1372,177,55,114,2752
23017,"Maine","PERU",321,547,63,10,37,978
23017,"Maine","PORTER",270,462,48,10,32,822
23017,"Maine","ROXBURY",76,143,17,4,9,249
23017,"Maine","RUMFORD",1137,1400,182,67,138,2924
23017,"Maine","STONEHAM",77,89,5,0,5,176
23017,"Maine","STOW",97,98,15,3,14,227
23017,"Maine","SUMNER",187,299,28,13,32,559
23017,"Maine","SWEDEN",115,116,14,3,8,256
23017,"Maine","UPTON",13,39,3,1,4,60
23017,"Maine","WATERFORD",338,493,59,20,37,947
23017,"Maine","WEST PARIS",340,544,77,21,33,1015
23017,"Maine","WOODSTOCK",274,404,54,16,48,796
23019,"Maine","ALTON",153,273,33,5,9,473
23019,"Maine","BANGOR",8155,6001,868,310,578,15912
23019,"Maine","BRADFORD",185,442,26,8,18,679
23019,"Maine","BRADLEY",335,411,42,15,31,834
23019,"Maine","BREWER",2165,2585,302,92,160,5304
23019,"Maine","BURLINGTON",41,131,10,6,6,194
23019,"Maine","CARMEL",459,1019,79,20,55,1632
23019,"Maine","CARROLL PLT",17,72,2,3,1,95
23019,"Maine","CHARLESTON",140,532,20,9,15,716
23019,"Maine","CHESTER",65,244,14,4,5,332
23019,"Maine","CLIFTON",170,293,30,11,14,518
23019,"Maine","CORINNA",304,738,61,22,36,1161
23019,"Maine","CORINTH",368,1057,60,9,37,1531
23019,"Maine","DEXTER",572,1062,103,38,54,1829
23019,"Maine","DIXMONT",232,431,31,20,32,746
23019,"Maine","DREW PLT",3,20,1,0,0,24
23019,"Maine","EAST MILLINOCKET",373,494,37,17,29,950
23019,"Maine","EDDINGTON",444,784,86,20,33,1367
23019,"Maine","EDINBURG",26,47,0,1,1,75
23019,"Maine","ENFIELD",259,493,56,9,36,853
23019,"Maine","ETNA",198,385,35,16,23,657
23019,"Maine","EXETER",177,330,28,6,9,550
23019,"Maine","GARLAND",167,344,34,7,25,577
23019,"Maine","GLENBURN",933,1411,143,34,85,2606
23019,"Maine","GREENBUSH",185,440,45,12,27,709
23019,"Maine","HAMPDEN",1929,2103,272,74,154,4532
23019,"Maine","HERMON",1101,2170,171,35,111,3588
23019,"Maine","HOLDEN",719,1123,102,36,70,2050
23019,"Maine","HOWLAND",248,387,28,6,29,698
23019,"Maine","HUDSON",194,490,38,12,24,758
23019,"Maine","KENDUSKEAG",202,461,45,17,17,742
23019,"Maine","KINGMAN TWP",16,53,1,0,1,71
23019,"Maine","LAGRANGE",112,237,9,4,8,370
23019,"Maine","LAKEVILLE",18,32,6,0,3,59
23019,"Maine","LEE",137,358,11,8,20,534
23019,"Maine","LEVANT",424,1025,74,15,57,1595
23019,"Maine","LINCOLN",704,1574,124,39,92,2533
23019,"Maine","LOWELL",61,155,4,9,3,232
23019,"Maine","MATTAWAMKEAG",105,222,17,7,11,362
23019,"Maine","MAXFIELD",17,36,3,2,0,58
23019,"Maine","MEDWAY",193,508,23,7,20,751
23019,"Maine","MILFORD",783,809,109,31,48,1780
23019,"Maine","MILLINOCKET",913,1161,101,32,78,2285
23019,"Maine","MOUNT CHASE",23,71,4,2,7,107
23019,"Maine","NEWBURGH",328,546,41,14,37,966
23019,"Maine","NEWPORT",576,1026,86,31,51,1770
23019,"Maine","OLD ORCHARD BEACH",2978,2147,223,86,165,5599
23019,"Maine","ORONO",3420,1445,364,115,212,5556
23019,"Maine","ORRINGTON",869,1313,131,38,64,2415
23019,"Maine","PASSADUMKEAG",37,165,10,3,9,224
23019,"Maine","PATTEN",138,322,20,7,24,511
23019,"Maine","PLYMOUTH",184,484,42,11,27,748
23019,"Maine","SEBOEIS PLT",15,19,0,0,1,35
23019,"Maine","SPRINGFIELD",34,130,7,1,6,178
23019,"Maine","STACYVILLE",35,148,3,5,8,199
23019,"Maine","STETSON",206,433,52,17,24,732
23019,"Maine","VEAZIE",556,483,53,24,52,1168
23019,"Maine","WEBSTER PLT",5,26,1,0,0,32
23019,"Maine","WINN",36,151,4,3,7,201
23019,"Maine","WOODVILLE",23,99,7,1,1,131
23021,"Maine","ABBOT",101,255,31,10,11,408
23021,"Maine","ATKINSON",50,120,10,1,7,188
23021,"Maine","BEAVER COVE",37,58,4,0,2,101
23021,"Maine","BOWERBANK",25,60,3,0,5,93
23021,"Maine","BROWNVILLE",211,332,37,13,18,611
23021,"Maine","DOVER-FOXCROFT",789,1138,111,58,80,2176
23021,"Maine","GREENVILLE",407,625,41,11,44,1128
23021,"Maine","GUILFORD",222,401,32,20,27,702
23021,"Maine","KINGSBURY PLT",9,9,1,0,0,19
23021,"Maine","LAKE VIEW PLT",33,39,0,0,1,73
23021,"Maine","MEDFORD",44,96,5,3,4,152
23021,"Maine","MILO",385,696,55,22,81,1239
23021,"Maine","MONSON",159,255,17,10,17,458
23021,"Maine","PARKMAN",151,283,38,3,23,498
23021,"Maine","SANGERVILLE",209,455,32,16,19,731
23021,"Maine","SEBEC",102,257,18,6,12,395
23021,"Maine","SHIRLEY",43,93,8,1,5,150
23021,"Maine","WELLINGTON",48,62,5,2,3,120
23021,"Maine","WILLIMANTIC",20,58,4,0,6,88
23023,"Maine","ARROWSIC",222,98,9,10,12,351
23023,"Maine","BATH",2717,1571,252,115,168,4823
23023,"Maine","BOWDOIN",589,1007,81,21,66,1764
23023,"Maine","BOWDOINHAM",876,803,109,41,56,1885
23023,"Maine","GEORGETOWN",402,281,29,32,25,769
23023,"Maine","PHIPPSBURG",617,692,67,27,37,1440
23023,"Maine","RICHMOND",733,961,115,53,77,1939
23023,"Maine","TOPSHAM",3109,2328,354,91,223,6105
23023,"Maine","WEST BATH",572,562,51,20,52,1257
23023,"Maine","WOOLWICH",827,1001,111,26,58,2023
23025,"Maine","ANSON",360,705,57,20,33,1175
23025,"Maine","ATHENS",160,275,32,13,21,501
23025,"Maine","BINGHAM",191,302,16,14,21,544
23025,"Maine","BRIGHTON PLT",12,32,2,2,1,49
23025,"Maine","CAMBRIDGE",65,173,18,5,8,269
23025,"Maine","CANAAN",362,647,78,27,42,1156
23025,"Maine","CARATUNK",27,23,0,0,0,50
23025,"Maine","CORNVILLE",251,410,36,16,19,732
23025,"Maine","DENNISTOWN PLT",5,19,0,0,2,26
23025,"Maine","DETROIT",147,228,19,10,11,415
23025,"Maine","EMBDEN",167,322,23,10,13,535
23025,"Maine","FAIRFIELD",1250,1745,206,56,125,3382
23025,"Maine","HARMONY",154,293,17,6,23,493
23025,"Maine","HARTLAND",222,600,37,9,20,888
23025,"Maine","HIGHLAND PLT",33,70,5,5,5,118
23025,"Maine","JACKMAN",121,376,20,5,22,544
23025,"Maine","MADISON",813,1262,107,30,94,2306
23025,"Maine","MERCER",158,225,16,8,17,424
23025,"Maine","MOOSE RIVER",15,94,5,1,4,119
23025,"Maine","MOSCOW",88,155,3,8,9,263
23025,"Maine","NEW PORTLAND",153,226,29,19,15,442
23025,"Maine","NORRIDGEWOCK",636,1022,92,32,58,1840
23025,"Maine","PALMYRA",309,681,54,20,25,1089
23025,"Maine","PITTSFIELD",670,1072,126,40,72,1980
23025,"Maine","PLEASANT RIDGE PLT",11,33,4,0,3,51
23025,"Maine","RIPLEY",72,155,12,21,9,269
23025,"Maine","SAINT ALBANS",282,768,52,27,34,1163
23025,"Maine","SKOWHEGAN",1674,2046,211,67,157,4155
23025,"Maine","SMITHFIELD",244,319,29,13,19,624
23025,"Maine","SOLON",233,316,22,16,20,607
23025,"Maine","STARKS",122,182,15,14,24,357
23025,"Maine","THE FORKS PLT",9,21,10,0,4,44
23025,"Maine","WEST FORKS PLT",15,31,3,0,0,49
23027,"Maine","BELFAST",2351,1241,177,100,129,3998
23027,"Maine","BELMONT",225,281,35,12,24,577
23027,"Maine","BROOKS",207,298,32,21,23,581
23027,"Maine","BURNHAM",213,404,35,13,24,689
23027,"Maine","FRANKFORT",220,381,34,14,22,671
23027,"Maine","FREEDOM",172,209,32,12,15,440
23027,"Maine","ISLESBORO",280,116,14,9,11,430
23027,"Maine","JACKSON",104,189,20,6,15,334
23027,"Maine","KNOX",131,281,23,9,15,459
23027,"Maine","LIBERTY",233,267,31,13,22,566
23027,"Maine","LINCOLNVILLE",883,510,78,43,60,1574
23027,"Maine","MONROE",247,246,32,17,19,561
23027,"Maine","MONTVILLE",288,279,28,30,22,647
23027,"Maine","MORRILL",192,296,29,6,28,551
23027,"Maine","NORTHPORT",528,408,48,16,37,1037
23027,"Maine","PALERMO",308,467,60,18,37,890
23027,"Maine","PROSPECT",157,224,17,5,15,418
23027,"Maine","SEARSMONT",370,390,45,23,25,853
23027,"Maine","SEARSPORT",689,710,78,36,57,1570
23027,"Maine","STOCKTON SPRINGS",445,471,43,28,34,1021
23027,"Maine","SWANVILLE",286,404,49,24,36,799
23027,"Maine","THORNDIKE",189,191,24,19,19,442
23027,"Maine","TROY",216,288,33,16,21,574
23027,"Maine","UNITY",448,474,70,44,34,1070
23027,"Maine","WALDO",192,244,18,21,14,489
23027,"Maine","WINTERPORT",866,1109,135,35,85,2230
23029,"Maine","ADDISON",210,409,36,10,15,680
23029,"Maine","ALEXANDER",80,208,7,5,13,313
23029,"Maine","BAILEYVILLE",263,372,43,8,21,707
23029,"Maine","BARING PLT",48,66,4,1,8,127
23029,"Maine","BEALS",113,141,18,6,10,288
23029,"Maine","BEDDINGTON",11,24,1,1,0,37
23029,"Maine","CALAIS",574,762,90,16,63,1505
23029,"Maine","CHARLOTTE",51,114,4,6,10,185
23029,"Maine","CHERRYFIELD",200,366,38,20,27,651
23029,"Maine","COLUMBIA",43,151,9,4,13,220
23029,"Maine","COLUMBIA FALLS",82,190,14,7,9,302
23029,"Maine","COOPER",33,55,3,2,2,95
23029,"Maine","CRAWFORD",21,48,2,1,1,73
23029,"Maine","CUTLER",70,202,7,6,12,297
23029,"Maine","DANFORTH",92,243,20,5,13,373
23029,"Maine","DEBLOIS",6,30,1,1,1,39
23029,"Maine","DENNYSVILLE",94,196,25,7,16,338
23029,"Maine","EAST MACHIAS",245,424,27,15,16,727
23029,"Maine","EASTPORT",408,309,24,39,35,815
23029,"Maine","GRAND LAKE STREAM PLT",32,59,8,0,3,102
23029,"Maine","HARRINGTON",129,322,19,8,23,501
23029,"Maine","JONESBORO",119,177,23,3,19,341
23029,"Maine","JONESPORT",240,377,34,10,27,688
23029,"Maine","LUBEC",374,359,26,19,45,823
23029,"Maine","MACHIAS",387,454,56,29,73,999
23029,"Maine","MACHIASPORT",184,249,12,38,23,506
23029,"Maine","MARSHFIELD",101,185,13,6,12,317
23029,"Maine","MEDDYBEMPS",30,62,5,1,7,105
23029,"Maine","MILBRIDGE",266,361,32,8,28,695
23029,"Maine","NORTHFIELD",38,65,2,2,1,108
23029,"Maine","PEMBROKE",191,273,15,12,9,500
23029,"Maine","PERRY",171,266,17,5,12,471
23029,"Maine","PRINCETON",119,330,34,12,15,510
23029,"Maine","ROBBINSTON",114,183,13,9,11,330
23029,"Maine","ROQUE BLUFFS",90,72,4,1,6,173
23029,"Maine","STEUBEN",199,368,38,13,22,640
23029,"Maine","TALMADGE",13,22,2,0,3,40
23029,"Maine","TOPSFIELD",20,95,2,3,1,121
23029,"Maine","VANCEBORO",28,57,5,3,2,95
23029,"Maine","WAITE",12,34,5,0,0,51
23029,"Maine","WESLEY",27,44,3,2,7,83
23029,"Maine","WHITING",139,168,10,4,14,335
23029,"Maine","WHITNEYVILLE",41,56,10,2,6,115
23031,"Maine","ACTON",542,820,68,23,44,1497
23031,"Maine","ALFRED",812,885,92,24,60,1873
23031,"Maine","ARUNDEL",1064,1198,141,43,90,2536
23031,"Maine","BERWICK",1539,2086,207,58,115,4005
23031,"Maine","BIDDEFORD",5505,3729,471,241,367,10313
23031,"Maine","BUXTON",1895,2538,237,82,146,4898
23031,"Maine","CORNISH",332,397,64,18,25,836
23031,"Maine","DAYTON",467,668,72,23,40,1270
23031,"Maine","ELIOT",2257,1704,200,58,134,4353
23031,"Maine","HOLLIS",1015,1329,154,58,84,2640
23031,"Maine","KENNEBUNK",4224,2648,345,125,308,7650
23031,"Maine","KENNEBUNKPORT",1356,910,98,30,108,2502
23031,"Maine","KITTERY",3474,1746,264,82,182,5748
23031,"Maine","LEBANON",939,1945,165,57,92,3198
23031,"Maine","LIMERICK",642,843,87,36,64,1672
23031,"Maine","LIMINGTON",697,1195,103,36,63,2094
23031,"Maine","LYMAN",1038,1300,132,62,85,2617
23031,"Maine","NEWFIELD",285,501,43,13,30,872
23031,"Maine","NORTH BERWICK",1165,1419,153,66,94,2897
23031,"Maine","OGUNQUIT",564,286,24,10,37,921
23031,"Maine","OLD TOWN",2029,1514,245,90,137,4015
23031,"Maine","PARSONSFIELD",367,552,59,22,27,1027
23031,"Maine","SACO",5902,4067,487,189,366,11011
23031,"Maine","SANFORD",4447,4744,555,231,385,10362
23031,"Maine","SHAPLEIGH",534,874,89,35,36,1568
23031,"Maine","SOUTH BERWICK",2227,1616,223,70,129,4265
23031,"Maine","WATERBORO",1373,2189,231,82,125,4000
23031,"Maine","WELLS",3275,2807,334,86,291,6793
23031,"Maine","YORK",4929,3260,374,109,356,9028
24001,"Maryland","Allegany",7875,21270,858,365,286,30654
24003,"Maryland","Anne Arundel",128419,122403,10408,3316,5535,270081
24005,"Maryland","Baltimore",218412,149477,11748,5338,5707,390682
24009,"Maryland","Calvert",18225,26176,1815,498,694,47408
24011,"Maryland","Caroline",4009,9368,445,129,162,14113
24013,"Maryland","Carroll",26567,58215,4286,1060,1720,91848
24015,"Maryland","Cecil",13650,28868,1665,568,518,45269
24017,"Maryland","Charles",49341,25614,1696,769,883,78303
24019,"Maryland","Dorchester",6245,8413,337,109,121,15225
24021,"Maryland","Frederick",56522,59522,5427,1745,2461,125677
24023,"Maryland","Garrett",2567,10776,400,107,161,14011
24025,"Maryland","Harford",47077,77860,5060,1596,2079,133672
24027,"Maryland","Howard",102597,47484,6282,2294,3536,162193
24029,"Maryland","Kent",4575,4876,312,116,142,10021
24031,"Maryland","Montgomery",357837,92704,11513,6620,10199,478873
24033,"Maryland","Prince George's",344049,32811,4557,4723,4245,390385
24035,"Maryland","Queen Anne's",7973,16993,940,272,345,26523
24037,"Maryland","St. Mary's",17534,28663,2270,507,868,49842
24039,"Maryland","Somerset",4196,5341,190,64,109,9900
24041,"Maryland","Talbot",8653,10724,632,203,341,20553
24043,"Maryland","Washington",21129,40998,2164,778,922,65991
24045,"Maryland","Wicomico",18050,22198,1297,432,570,42547
24047,"Maryland","Worcester",9753,17210,735,249,326,28273
24510,"Maryland","Baltimore City",202673,25205,4568,4087,2869,239402
25001,"Massachusetts","Barnstable",13005,11195,1049,348,783,26380
25001,"Massachusetts","Bourne",4910,5201,442,129,353,11035
25001,"Massachusetts","Brewster",3813,2370,297,112,223,6815
25001,"Massachusetts","Chatham",2398,1796,216,68,165,4643
25001,"Massachusetts","Dennis",4887,3751,372,138,284,9432
25001,"Massachusetts","Eastham",2203,1199,134,61,105,3702
25001,"Massachusetts","Falmouth",11467,7165,728,273,641,20274
25001,"Massachusetts","Harwich",4560,3294,340,132,246,8572
25001,"Massachusetts","Mashpee",4448,3839,347,119,231,8984
25001,"Massachusetts","Orleans",2687,1511,192,65,140,4595
25001,"Massachusetts","Provincetown",2082,208,38,35,36,2399
25001,"Massachusetts","Sandwich",6017,5846,510,143,407,12923
25001,"Massachusetts","Truro",1095,361,62,33,38,1589
25001,"Massachusetts","Wellfleet",1554,515,73,73,67,2282
25001,"Massachusetts","Yarmouth",7304,5848,537,190,408,14287
25003,"Massachusetts","Adams",2413,1285,189,80,113,4080
25003,"Massachusetts","Alford",226,52,8,8,13,307
25003,"Massachusetts","Becket",571,368,37,25,46,1047
25003,"Massachusetts","Cheshire",978,741,83,30,59,1891
25003,"Massachusetts","Clarksburg",510,327,29,12,18,896
25003,"Massachusetts","Dalton",2190,940,166,83,104,3483
25003,"Massachusetts","Egremont",621,147,30,30,17,845
25003,"Massachusetts","Florida",191,170,17,11,11,400
25003,"Massachusetts","Great Barrington",2880,580,103,128,73,3764
25003,"Massachusetts","Hancock",189,159,24,9,16,397
25003,"Massachusetts","Hinsdale",606,403,55,37,35,1136
25003,"Massachusetts","Lanesborough",998,597,77,32,43,1747
25003,"Massachusetts","Lee",1969,852,115,86,77,3099
25003,"Massachusetts","Lenox",2234,572,116,70,104,3096
25003,"Massachusetts","Monterey",417,88,20,12,17,554
25003,"Massachusetts","Mount Washington",76,19,5,4,3,107
25003,"Massachusetts","New Ashford",101,39,14,6,1,161
25003,"Massachusetts","New Marlborough",564,218,34,35,20,871
25003,"Massachusetts","N. Adams",3730,1570,241,172,166,5879
25003,"Massachusetts","Otis",431,407,43,18,25,924
25003,"Massachusetts","Peru",255,207,34,8,15,519
25003,"Massachusetts","Pittsfield",13907,4771,763,515,522,20478
25003,"Massachusetts","Richmond",706,218,28,26,27,1005
25003,"Massachusetts","Sandisfield",254,190,22,12,10,488
25003,"Massachusetts","Savoy",184,163,24,11,19,401
25003,"Massachusetts","Sheffield",1242,530,80,46,44,1942
25003,"Massachusetts","Stockbridge",965,252,29,30,29,1305
25003,"Massachusetts","Tyringham",201,70,13,0,15,299
25003,"Massachusetts","Washington",217,89,9,5,7,327
25003,"Massachusetts","W. Stockbridge",659,178,28,16,20,901
25003,"Massachusetts","Williamstown",2916,478,83,59,87,3623
25003,"Massachusetts","Windsor",313,159,36,11,17,536
25005,"Massachusetts","Acushnet",2401,2834,174,87,176,5672
25005,"Massachusetts","Attleboro",10518,8571,1032,321,439,20881
25005,"Massachusetts","Berkley",1455,1926,149,51,98,3679
25005,"Massachusetts","Dartmouth",8586,6738,610,235,434,16603
25005,"Massachusetts","Dighton",1602,2149,172,67,132,4122
25005,"Massachusetts","Easton",6556,5231,623,134,467,13011
25005,"Massachusetts","Fairhaven",4264,3824,317,133,215,8753
25005,"Massachusetts","Fall River",17467,10850,943,501,1062,30823
25005,"Massachusetts","Freetown",2035,2649,178,68,147,5077
25005,"Massachusetts","Mansfield",6879,5073,697,142,550,13341
25005,"Massachusetts","New Bedford",20812,10327,955,586,928,33608
25005,"Massachusetts","N. Attleborough",7059,6716,863,226,570,15434
25005,"Massachusetts","Norton",4555,4428,496,113,449,10041
25005,"Massachusetts","Raynham",3327,3806,364,77,240,7814
25005,"Massachusetts","Rehoboth",2784,3574,322,110,187,6977
25005,"Massachusetts","Seekonk",3663,3572,322,106,214,7877
25005,"Massachusetts","Somerset",4901,4566,330,169,311,10277
25005,"Massachusetts","Swansea",3928,4351,285,103,206,8873
25005,"Massachusetts","Taunton",12365,9973,1042,362,738,24480
25005,"Massachusetts","Westport",4383,4285,306,98,271,9343
25007,"Massachusetts","Aquinnah",232,34,6,7,8,287
25007,"Massachusetts","Chilmark",617,94,30,23,24,788
25007,"Massachusetts","Edgartown",1787,779,99,53,92,2810
25007,"Massachusetts","Gosnold",36,27,2,0,6,71
25007,"Massachusetts","Oak Bluffs",2098,738,87,44,82,3049
25007,"Massachusetts","Tisbury",1942,476,72,83,81,2654
25007,"Massachusetts","W. Tisbury",1688,329,70,49,56,2192
25009,"Massachusetts","Amesbury",5174,3231,527,151,319,9402
25009,"Massachusetts","Andover",11222,6522,895,202,731,19572
25009,"Massachusetts","Beverly",13185,6904,1142,332,850,22413
25009,"Massachusetts","Boxford",2454,2194,297,35,228,5208
25009,"Massachusetts","Danvers",7752,6484,691,179,500,15606
25009,"Massachusetts","Essex",1272,758,166,34,74,2304
25009,"Massachusetts","Georgetown",2347,2228,331,49,147,5102
25009,"Massachusetts","Gloucester",9808,5355,696,280,569,16708
25009,"Massachusetts","Groveland",1822,1934,190,52,127,4125
25009,"Massachusetts","Hamilton",2631,1476,318,69,268,4762
25009,"Massachusetts","Haverhill",15407,12050,1343,418,911,30129
25009,"Massachusetts","Ipswich",4939,3013,459,138,297,8846
25009,"Massachusetts","Lawrence",19852,3535,476,220,454,24537
25009,"Massachusetts","Lynn",22164,9311,925,430,1359,34189
25009,"Massachusetts","Lynnfield",3238,3829,297,72,257,7693
25009,"Massachusetts","Manchester-by-the-Sea",2249,954,227,34,159,3623
25009,"Massachusetts","Marblehead",8111,3759,665,117,506,13158
25009,"Massachusetts","Merrimac",1895,1622,226,57,135,3935
25009,"Massachusetts","Methuen",11662,10235,811,236,640,23584
25009,"Massachusetts","Middleton",2159,2663,192,33,164,5211
25009,"Massachusetts","Nahant",1347,864,87,23,57,2378
25009,"Massachusetts","Newbury",2465,1716,215,63,164,4623
25009,"Massachusetts","Newburyport",7385,3114,520,140,425,11584
25009,"Massachusetts","N. Andover",8499,6391,801,119,581,16391
25009,"Massachusetts","Peabody",14395,12036,962,262,894,28549
25009,"Massachusetts","Rockport",3122,1371,225,79,179,4976
25009,"Massachusetts","Rowley",1679,1809,221,53,143,3905
25009,"Massachusetts","Salem",14950,5458,750,401,624,22183
25009,"Massachusetts","Salisbury",2098,2249,216,71,176,4810
25009,"Massachusetts","Saugus",6385,7305,414,146,468,14718
25009,"Massachusetts","Swampscott",5554,2586,336,100,309,8885
25009,"Massachusetts","Topsfield",2100,1566,214,34,300,4214
25009,"Massachusetts","Wenham",1368,774,192,24,120,2478
25009,"Massachusetts","W. Newbury",1620,1020,188,26,134,2988
25011,"Massachusetts","Ashfield",836,184,52,44,39,1155
25011,"Massachusetts","Bernardston",711,382,81,27,43,1244
25011,"Massachusetts","Buckland",703,230,53,39,42,1067
25011,"Massachusetts","Charlemont",407,228,40,25,35,735
25011,"Massachusetts","Colrain",513,257,59,62,43,934
25011,"Massachusetts","Conway",865,249,47,39,35,1235
25011,"Massachusetts","Deerfield",1968,777,161,75,114,3095
25011,"Massachusetts","Erving",420,300,59,32,23,834
25011,"Massachusetts","Gill",579,259,57,32,26,953
25011,"Massachusetts","Greenfield",5574,2098,372,309,344,8697
25011,"Massachusetts","Hawley",105,67,14,7,13,206
25011,"Massachusetts","Heath",244,165,24,12,14,459
25011,"Massachusetts","Leverett",996,185,24,56,35,1296
25011,"Massachusetts","Leyden",306,139,23,20,14,502
25011,"Massachusetts","Monroe",25,26,5,2,1,59
25011,"Massachusetts","Montague",2858,1095,213,181,144,4491
25011,"Massachusetts","New Salem",337,208,28,22,19,614
25011,"Massachusetts","Northfield",1013,533,91,50,70,1757
25011,"Massachusetts","Orange",1487,1550,222,78,98,3435
25011,"Massachusetts","Rowe",122,99,7,7,6,241
25011,"Massachusetts","Shelburne",821,230,49,51,46,1197
25011,"Massachusetts","Shutesbury",980,142,38,83,39,1282
25011,"Massachusetts","Sunderland",1353,387,82,62,64,1948
25011,"Massachusetts","Warwick",271,142,25,19,17,474
25011,"Massachusetts","Wendell",402,104,21,48,16,591
25011,"Massachusetts","Whately",582,328,55,30,35,1030
25013,"Massachusetts","Agawam",6208,7421,651,208,389,14877
25013,"Massachusetts","Blandford",256,405,28,8,20,717
25013,"Massachusetts","Brimfield",793,1113,117,34,69,2126
25013,"Massachusetts","Chester",238,372,55,13,18,696
25013,"Massachusetts","Chicopee",12338,9841,1046,472,844,24541
25013,"Massachusetts","E. Longmeadow",4089,4441,402,115,288,9335
25013,"Massachusetts","Granville",335,548,55,20,28,986
25013,"Massachusetts","Hampden",1188,1645,154,37,93,3117
25013,"Massachusetts","Holland",475,720,106,33,47,1381
25013,"Massachusetts","Holyoke",11656,4022,509,392,460,17039
25013,"Massachusetts","Longmeadow",5311,3457,412,128,326,9634
25013,"Massachusetts","Ludlow",4483,5097,410,144,307,10441
25013,"Massachusetts","Monson",1922,2259,245,108,146,4680
25013,"Massachusetts","Montgomery",199,281,32,12,6,530
25013,"Massachusetts","Palmer",2475,3083,322,148,165,6193
25013,"Massachusetts","Russell",278,480,50,13,27,848
25013,"Massachusetts","Southwick",1859,2961,267,73,167,5327
25013,"Massachusetts","Springfield",40341,11231,1409,820,1385,55186
25013,"Massachusetts","Tolland",101,190,8,8,12,319
25013,"Massachusetts","Wales",365,550,52,21,29,1017
25013,"Massachusetts","Westfield",8225,9021,1034,337,689,19306
25013,"Massachusetts","W. Springfield",5711,5537,589,208,383,12428
25013,"Massachusetts","Wilbraham",3744,4010,369,104,385,8612
25015,"Massachusetts","Amherst",12357,1248,445,613,403,15066
25015,"Massachusetts","Belchertown",4408,3153,392,192,273,8418
25015,"Massachusetts","Chesterfield",398,267,39,39,25,768
25015,"Massachusetts","Cummington",334,156,31,33,13,567
25015,"Massachusetts","Easthampton",6213,2599,367,305,312,9796
25015,"Massachusetts","Goshen",364,213,28,15,18,638
25015,"Massachusetts","Granby",1651,1699,173,93,125,3741
25015,"Massachusetts","Hadley",2149,867,105,98,94,3313
25015,"Massachusetts","Hatfield",1284,660,77,61,70,2152
25015,"Massachusetts","Huntington",460,611,71,35,24,1201
25015,"Massachusetts","Middlefield",155,115,16,10,11,307
25015,"Massachusetts","Northampton",13512,1878,341,638,626,16995
25015,"Massachusetts","Pelham",748,98,25,22,22,915
25015,"Massachusetts","Plainfield",263,107,13,18,18,419
25015,"Massachusetts","Southampton",1744,1692,193,64,148,3841
25015,"Massachusetts","S. Hadley",5208,3254,383,180,313,9338
25015,"Massachusetts","Ware",1853,2189,243,77,174,4536
25015,"Massachusetts","Westhampton",629,408,46,27,26,1136
25015,"Massachusetts","Williamsburg",1207,347,69,58,33,1714
25015,"Massachusetts","Worthington",430,229,41,46,17,763
25017,"Massachusetts","Acton",9198,2555,552,208,454,12967
25017,"Massachusetts","Arlington",20539,4652,732,457,891,27271
25017,"Massachusetts","Ashby",722,974,129,45,63,1933
25017,"Massachusetts","Ashland",5684,2768,457,105,312,9326
25017,"Massachusetts","Ayer",2162,1498,292,65,159,4176
25017,"Massachusetts","Bedford",5085,2211,404,92,274,8066
25017,"Massachusetts","Belmont",10252,3106,561,237,535,14691
25017,"Massachusetts","Billerica",10100,10319,976,264,699,22358
25017,"Massachusetts","Boxborough",1987,756,159,36,131,3069
25017,"Massachusetts","Burlington",7633,5434,558,123,471,14219
25017,"Massachusetts","Cambridge",46563,3323,1213,1032,1151,53282
25017,"Massachusetts","Carlisle",2302,732,192,43,122,3391
25017,"Massachusetts","Chelmsford",10705,7661,1093,237,746,20442
25017,"Massachusetts","Concord",8460,1951,503,150,383,11447
25017,"Massachusetts","Dracut",6645,8319,821,187,465,16437
25017,"Massachusetts","Dunstable",954,837,140,26,78,2035
25017,"Massachusetts","Everett",9461,3940,309,165,348,14223
25017,"Massachusetts","Framingham",20520,7063,1196,347,902,30028
25017,"Massachusetts","Groton",3917,2138,400,96,261,6812
25017,"Massachusetts","Holliston",5291,2563,458,92,363,8767
25017,"Massachusetts","Hopkinton",5358,2911,560,100,407,9336
25017,"Massachusetts","Hudson",6028,3775,599,118,345,10865
25017,"Massachusetts","Lexington",13900,3279,610,244,558,18591
25017,"Massachusetts","Lincoln",2996,625,178,49,109,3957
25017,"Massachusetts","Littleton",3445,1876,393,56,231,6001
25017,"Massachusetts","Lowell",23555,10584,1437,552,1218,37346
25017,"Massachusetts","Malden",15845,5538,641,335,636,22995
25017,"Massachusetts","Marlborough",10577,5959,918,225,657,18336
25017,"Massachusetts","Maynard",3860,1671,303,77,179,6090
25017,"Massachusetts","Medford",20690,7671,897,378,892,30528
25017,"Massachusetts","Melrose",10687,4832,678,172,592,16961
25017,"Massachusetts","Natick",13420,4870,853,222,732,20097
25017,"Massachusetts","Newton",36463,7764,1466,514,1262,47469
25017,"Massachusetts","N. Reading",4283,3986,470,87,328,9154
25017,"Massachusetts","Pepperell",2932,3098,455,84,277,6846
25017,"Massachusetts","Reading",8848,5373,681,142,561,15605
25017,"Massachusetts","Sherborn",1766,617,197,23,120,2723
25017,"Massachusetts","Shirley",1637,1432,214,49,118,3450
25017,"Massachusetts","Somerville",33740,4128,1109,841,1056,40874
25017,"Massachusetts","Stoneham",6962,5243,525,110,453,13293
25017,"Massachusetts","Stow",2708,1261,286,70,162,4487
25017,"Massachusetts","Sudbury",7402,2510,473,86,469,10940
25017,"Massachusetts","Tewksbury",7602,8432,843,183,548,17608
25017,"Massachusetts","Townsend",2082,2550,361,76,161,5230
25017,"Massachusetts","Tyngsborough",3061,3167,364,79,174,6845
25017,"Massachusetts","Wakefield",8294,6060,677,160,627,15818
25017,"Massachusetts","Waltham",17355,7592,962,370,450,26729
25017,"Massachusetts","Watertown",13166,3941,629,323,609,18668
25017,"Massachusetts","Wayland",6114,1684,374,98,338,8608
25017,"Massachusetts","Westford",7854,4706,824,160,527,14071
25017,"Massachusetts","Weston",4368,1648,332,57,291,6696
25017,"Massachusetts","Wilmington",6205,6167,612,125,486,13595
25017,"Massachusetts","Winchester",8062,3701,584,128,513,12988
25017,"Massachusetts","Woburn",10915,8342,791,211,631,20890
25019,"Massachusetts","Nantucket",4146,1892,260,108,177,6583
25021,"Massachusetts","Avon",1254,1068,79,40,71,2512
25021,"Massachusetts","Bellingham",4033,4059,502,100,288,8982
25021,"Massachusetts","Braintree",10469,8427,766,216,748,20626
25021,"Massachusetts","Brookline",24583,3175,731,398,793,29680
25021,"Massachusetts","Canton",7308,4731,574,109,448,13170
25021,"Massachusetts","Cohasset",2895,1629,244,46,226,5040
25021,"Massachusetts","Dedham",8621,4778,570,149,508,14626
25021,"Massachusetts","Dover",2063,1137,266,29,177,3672
25021,"Massachusetts","Foxborough",5132,4161,580,95,376,10344
25021,"Massachusetts","Franklin",9527,6996,988,172,750,18433
25021,"Massachusetts","Holbrook",2912,2385,248,90,164,5799
25021,"Massachusetts","Medfield",4409,2400,427,61,502,7799
25021,"Massachusetts","Medway",4009,2948,458,67,318,7800
25021,"Massachusetts","Millis",2620,1890,309,58,173,5050
25021,"Massachusetts","Milton",10752,4286,595,149,580,16362
25021,"Massachusetts","Needham",12797,4019,746,150,760,18472
25021,"Massachusetts","Norfolk",2956,2458,391,60,277,6142
25021,"Massachusetts","Norwood",9000,5692,656,184,584,16116
25021,"Massachusetts","Plainville",2216,2223,305,68,172,4984
25021,"Massachusetts","Quincy",25477,13321,1460,557,1377,42192
25021,"Massachusetts","Randolph",11509,3098,335,159,305,15406
25021,"Massachusetts","Sharon",7219,2447,404,124,334,10528
25021,"Massachusetts","Stoughton",8451,4920,542,162,473,14548
25021,"Massachusetts","Walpole",7270,6046,755,135,622,14828
25021,"Massachusetts","Wellesley",10568,3235,666,121,676,15266
25021,"Massachusetts","Westwood",5319,3218,460,93,404,9494
25021,"Massachusetts","Weymouth",15398,11983,1159,380,947,29867
25021,"Massachusetts","Wrentham",3052,2993,390,79,290,6804
25023,"Massachusetts","Abington",4115,4017,417,102,261,8912
25023,"Massachusetts","Bridgewater",5718,6261,624,167,370,13140
25023,"Massachusetts","Brockton",25593,8801,920,388,783,36485
25023,"Massachusetts","Carver",2529,3206,364,72,196,6367
25023,"Massachusetts","Duxbury",5137,3888,531,112,428,10096
25023,"Massachusetts","E. Bridgewater",3174,4073,430,86,252,8015
25023,"Massachusetts","Halifax",1794,2312,228,58,127,4519
25023,"Massachusetts","Hanover",3750,4267,400,71,350,8838
25023,"Massachusetts","Hanson",2432,3124,329,58,215,6158
25023,"Massachusetts","Hingham",8510,4810,691,142,702,14855
25023,"Massachusetts","Hull",3688,2356,253,66,180,6543
25023,"Massachusetts","Kingston",3471,3579,381,84,219,7734
25023,"Massachusetts","Lakeville",2466,3374,315,86,263,6504
25023,"Massachusetts","Marion",1861,1159,151,49,103,3323
25023,"Massachusetts","Marshfield",7343,7215,697,181,484,15920
25023,"Massachusetts","Mattapoisett",2125,1820,163,52,154,4314
25023,"Massachusetts","Middleborough",4837,6583,676,164,395,12655
25023,"Massachusetts","Norwell",3277,2837,322,56,274,6766
25023,"Massachusetts","Pembroke",4630,4913,588,123,362,10616
25023,"Massachusetts","Plymouth",15602,14309,1597,422,1093,33023
25023,"Massachusetts","Plympton",727,883,114,28,56,1808
25023,"Massachusetts","Rochester",1368,1743,161,50,112,3434
25023,"Massachusetts","Rockland",4403,4313,464,115,266,9561
25023,"Massachusetts","Scituate",6512,4457,542,146,458,12115
25023,"Massachusetts","Wareham",5435,5104,500,176,318,11533
25023,"Massachusetts","W. Bridgewater",1623,2150,227,51,160,4211
25023,"Massachusetts","Whitman",3393,3815,457,98,298,8061
25025,"Massachusetts","Boston",221093,38087,7025,3969,7192,277366
25025,"Massachusetts","Chelsea",7500,1587,207,127,612,10033
25025,"Massachusetts","Revere",11964,6895,446,239,537,20081
25025,"Massachusetts","Winthrop",5194,3852,318,130,233,9727
25027,"Massachusetts","Ashburnham",1439,1522,247,66,125,3399
25027,"Massachusetts","Athol",2076,2335,328,116,201,5056
25027,"Massachusetts","Auburn",4496,4000,553,92,314,9455
25027,"Massachusetts","Barre",1201,1429,164,58,84,2936
25027,"Massachusetts","Berlin",1009,745,124,38,50,1966
25027,"Massachusetts","Blackstone",1850,2327,254,59,133,4623
25027,"Massachusetts","Bolton",1891,1036,230,54,134,3345
25027,"Massachusetts","Boylston",1424,1125,176,35,101,2861
25027,"Massachusetts","Brookfield",708,936,102,27,54,1827
25027,"Massachusetts","Charlton",2709,3856,461,99,216,7341
25027,"Massachusetts","Clinton",3767,2748,396,100,226,7237
25027,"Massachusetts","Douglas",1780,2685,299,64,147,4975
25027,"Massachusetts","Dudley",2113,2871,295,69,139,5487
25027,"Massachusetts","E. Brookfield",417,664,65,18,53,1217
25027,"Massachusetts","Fitchburg",8590,5587,812,259,431,15679
25027,"Massachusetts","Gardner",4196,3542,590,157,277,8762
25027,"Massachusetts","Grafton",5372,3883,586,130,316,10287
25027,"Massachusetts","Hardwick",568,709,77,28,39,1421
25027,"Massachusetts","Harvard",2515,889,182,50,140,3776
25027,"Massachusetts","Holden",5605,4612,661,149,413,11440
25027,"Massachusetts","Hopedale",1759,1375,197,49,131,3511
25027,"Massachusetts","Hubbardston",1040,1376,203,36,110,2765
25027,"Massachusetts","Lancaster",1850,1651,284,59,165,4009
25027,"Massachusetts","Leicester",2423,2825,318,72,190,5828
25027,"Massachusetts","Leominster",9840,8199,1076,262,574,19951
25027,"Massachusetts","Lunenburg",2942,2802,386,79,231,6440
25027,"Massachusetts","Mendon",1530,1694,214,30,116,3584
25027,"Massachusetts","Milford",7370,5237,601,159,459,13826
25027,"Massachusetts","Millbury",3162,3445,394,83,204,7288
25027,"Massachusetts","Millville",624,874,103,28,43,1672
25027,"Massachusetts","New Braintree",246,326,22,18,11,623
25027,"Massachusetts","Northborough",5130,2964,523,104,345,9066
25027,"Massachusetts","Northbridge",3425,3977,574,104,327,8407
25027,"Massachusetts","N. Brookfield",907,1413,160,36,75,2591
25027,"Massachusetts","Oakham",435,633,72,19,25,1184
25027,"Massachusetts","Oxford",2744,3576,405,83,217,7025
25027,"Massachusetts","Paxton",1213,1197,151,38,109,2708
25027,"Massachusetts","Petersham",417,312,46,19,33,827
25027,"Massachusetts","Phillipston",374,550,67,13,26,1030
25027,"Massachusetts","Princeton",1183,898,124,35,105,2345
25027,"Massachusetts","Royalston",314,321,32,16,19,702
25027,"Massachusetts","Rutland",2022,2344,328,73,181,4948
25027,"Massachusetts","Shrewsbury",10620,6808,894,197,688,19207
25027,"Massachusetts","Southborough",3530,1898,328,56,271,6083
25027,"Massachusetts","Southbridge",3714,2586,374,110,197,6981
25027,"Massachusetts","Spencer",2265,3045,296,83,186,5875
25027,"Massachusetts","Sterling",2162,2327,344,64,169,5066
25027,"Massachusetts","Sturbridge",2534,2415,320,89,164,5522
25027,"Massachusetts","Sutton",2312,2881,313,61,181,5748
25027,"Massachusetts","Templeton",1521,2068,272,59,138,4058
25027,"Massachusetts","Upton",2296,1818,327,56,179,4676
25027,"Massachusetts","Uxbridge",3266,3698,492,93,249,7798
25027,"Massachusetts","Warren",904,1266,142,39,61,2412
25027,"Massachusetts","Webster",3119,3575,406,103,208,7411
25027,"Massachusetts","Westborough",6023,2752,486,138,377,9776
25027,"Massachusetts","W. Boylston",2136,1838,233,56,159,4422
25027,"Massachusetts","W. Brookfield",869,1008,111,40,69,2097
25027,"Massachusetts","Westminster",1958,2165,276,68,156,4623
25027,"Massachusetts","Winchendon",1789,2312,292,91,134,4618
25027,"Massachusetts","Worcester",43084,17732,2410,1172,1905,66303
26001,"Michigan","ALCONA",1732,4201,164,54,47,6198
26003,"Michigan","ALGER",1663,2585,177,67,26,4518
26005,"Michigan","ALLEGAN",18050,34183,2513,596,444,55786
26007,"Michigan","ALPENA",4877,9090,498,160,73,14698
26009,"Michigan","ANTRIM",4448,8469,459,146,60,13582
26011,"Michigan","ARENAC",2384,4950,270,60,32,7696
26013,"Michigan","BARAGA",1156,2158,106,49,21,3490
26015,"Michigan","BARRY",9114,19202,1424,346,243,30329
26017,"Michigan","BAY",21642,28328,2189,544,274,52977
26019,"Michigan","BENZIE",4108,5539,382,149,50,10228
26021,"Michigan","BERRIEN",29495,38647,2760,662,467,72031
26023,"Michigan","BRANCH",5061,11786,582,151,83,17663
26025,"Michigan","CALHOUN",24157,31494,2284,635,332,58902
26027,"Michigan","CASS",7270,14243,753,199,130,22595
26029,"Michigan","CHARLEVOIX",5137,8674,532,178,68,14589
26031,"Michigan","CHEBOYGAN",4302,8683,463,140,84,13672
26033,"Michigan","CHIPPEWA",5379,9122,583,243,129,15456
26035,"Michigan","CLARE",4249,8505,435,120,80,13389
26037,"Michigan","CLINTON",16492,21636,1886,379,262,40655
26039,"Michigan","CRAWFORD",2110,4354,267,66,47,6844
26041,"Michigan","DELTA",6436,11121,660,182,93,18492
26043,"Michigan","DICKINSON",3923,8580,450,123,89,13165
26045,"Michigan","EATON",24938,27609,2618,602,454,56221
26047,"Michigan","EMMET",6972,10616,806,279,129,18802
26049,"Michigan","GENESEE",102751,84175,6221,2193,956,196296
26051,"Michigan","GLADWIN",3794,8124,393,87,74,12472
26053,"Michigan","GOGEBIC",2925,4018,213,118,55,7329
26055,"Michigan","GD. TRAVERSE",20965,27413,2149,756,306,51589
26057,"Michigan","GRATIOT",5666,9880,687,140,92,16465
26059,"Michigan","HILLSDALE",4799,14095,700,184,162,19940
26061,"Michigan","HOUGHTON",6018,8475,837,216,78,15624
26063,"Michigan","HURON",4579,10692,477,104,65,15917
26065,"Michigan","INGHAM",79110,43868,5305,1846,1009,131138
26067,"Michigan","IONIA",8352,16635,1355,286,226,26854
26069,"Michigan","IOSCO",4345,8345,459,146,66,13361
26071,"Michigan","IRON",2004,3675,175,36,20,5910
26073,"Michigan","ISABELLA",11404,12338,1093,396,161,25392
26075,"Michigan","JACKSON",25795,39793,2901,713,475,69677
26077,"Michigan","KALAMAZOO",67148,51034,5644,1634,839,126299
26079,"Michigan","KALKASKA",2280,6116,283,118,36,8833
26081,"Michigan","KENT",138683,148180,14246,3996,3079,308184
26083,"Michigan","KEWEENAW",527,814,62,20,11,1434
26085,"Michigan","LAKE",1939,3159,152,48,30,5328
26087,"Michigan","LAPEER",12734,30037,1730,426,256,45183
26089,"Michigan","LEELANAU",6774,7239,510,197,37,14757
26091,"Michigan","LENAWEE",16750,26430,2044,449,266,45939
26093,"Michigan","LIVINGSTON",34384,65680,4266,911,625,105866
26095,"Michigan","LUCE",681,1756,103,29,10,2579
26097,"Michigan","MACKINAC",2085,3744,180,67,21,6097
26099,"Michigan","MACOMB",176317,224665,12862,3886,1582,419312
26101,"Michigan","MANISTEE",4979,6915,456,200,49,12599
26103,"Michigan","MARQUETTE",16042,14646,1458,583,247,32976
26105,"Michigan","MASON",5281,8505,601,189,109,14685
26107,"Michigan","MECOSTA",5827,10305,697,229,110,17168
26109,"Michigan","MENOMINEE",3539,6702,351,118,58,10768
26111,"Michigan","MIDLAND",15635,23846,2216,407,402,42506
26113,"Michigan","MISSAUKEE",1565,5386,241,74,51,7317
26115,"Michigan","MONROE",26863,43261,2985,707,402,74218
26117,"Michigan","MONTCALM",7874,16907,1316,292,220,26609
26119,"Michigan","MONTMORENCY",1287,3498,159,44,21,5009
26121,"Michigan","MUSKEGON",37304,36127,3182,964,511,78088
26123,"Michigan","NEWAYGO",6212,15173,878,197,180,22640
26125,"Michigan","OAKLAND",343070,289203,23154,6396,2791,664614
26127,"Michigan","OCEANA",3973,7228,492,116,121,11930
26129,"Michigan","OGEMAW",3030,6827,353,118,59,10387
26131,"Michigan","ONTONAGON",1176,2066,128,29,27,3426
26133,"Michigan","OSCEOLA",2705,7336,401,96,71,10609
26135,"Michigan","OSCODA",1044,2843,140,18,28,4073
26137,"Michigan","OTSEGO",3556,8266,482,163,71,12538
26139,"Michigan","OTTAWA",44973,88467,6324,1418,1552,142734
26141,"Michigan","PRESQUE ISLE",2400,4488,237,50,43,7218
26143,"Michigan","ROSCOMMON",4287,8141,413,142,58,13041
26145,"Michigan","SAGINAW",44396,45469,3199,780,476,94320
26147,"Michigan","ST. CLAIR",24553,49051,2972,1062,365,78003
26149,"Michigan","ST. JOSEPH",7526,14884,934,290,123,23757
26151,"Michigan","SANILAC",4873,13446,662,170,98,19249
26153,"Michigan","SCHOOLCRAFT",1369,2556,165,31,33,4154
26155,"Michigan","SHIAWASSEE",12546,19230,1660,362,313,34111
26157,"Michigan","TUSCOLA",7429,17102,872,221,172,25796
26159,"Michigan","VAN BUREN",13258,17890,1480,417,229,33274
26161,"Michigan","WASHTENAW",128483,50631,5840,2472,1152,188578
26163,"Michigan","WAYNE",519444,228993,18801,7784,2816,777838
26165,"Michigan","WEXFORD",4436,10000,579,192,91,15298
27001,"Minnesota","AITKIN",3134,5516,263,67,251,9231
27003,"Minnesota","ANOKA",75500,93339,7726,2123,7070,185758
27005,"Minnesota","BECKER",5208,10880,580,130,424,17222
27007,"Minnesota","BELTRAMI",8688,10783,780,420,893,21564
27009,"Minnesota","BENTON",5640,12872,683,245,618,20058
27011,"Minnesota","BIG STONE",921,1608,94,20,112,2755
27013,"Minnesota","BLUE EARTH",14428,15667,1604,587,1307,33593
27015,"Minnesota","BROWN",3763,8708,503,136,669,13779
27017,"Minnesota","CARLTON",8460,8160,703,233,655,18211
27019,"Minnesota","CARVER",21508,29056,2461,488,2183,55696
27021,"Minnesota","CASS",4949,9982,414,212,442,15999
27023,"Minnesota","CHIPPEWA",1978,3764,209,70,201,6222
27025,"Minnesota","CHISAGO",9278,18441,1213,317,979,30228
27027,"Minnesota","CLAY",12971,13543,1486,416,982,29398
27029,"Minnesota","CLEARWATER",1100,2925,94,33,93,4245
27031,"Minnesota","COOK",1912,1156,105,77,145,3395
27033,"Minnesota","COTTONWOOD",1678,3679,150,41,173,5721
27035,"Minnesota","CROW WING",10982,22287,1174,311,1088,35842
27037,"Minnesota","DAKOTA",110483,99583,9879,2678,8817,231440
27039,"Minnesota","DODGE",3102,6527,454,98,473,10654
27041,"Minnesota","DOUGLAS",6227,13966,781,167,644,21785
27043,"Minnesota","FARIBAULT",2153,4659,271,63,266,7412
27045,"Minnesota","FILLMORE",3872,6271,409,103,400,11055
27047,"Minnesota","FREEBORN",6041,8808,511,169,522,16051
27049,"Minnesota","GOODHUE",9446,14041,1130,262,838,25717
27051,"Minnesota","GRANT",1105,2063,159,27,119,3473
27053,"Minnesota","HENNEPIN",429288,191770,24400,10310,24209,679977
27055,"Minnesota","HOUSTON",4145,5616,394,135,314,10604
27057,"Minnesota","HUBBARD",3423,7261,342,132,347,11505
27059,"Minnesota","ISANTI",5657,13635,765,219,740,21016
27061,"Minnesota","ITASCA",9015,12920,792,274,879,23880
27063,"Minnesota","JACKSON",1492,3609,181,49,153,5484
27065,"Minnesota","KANABEC",2327,5230,298,81,241,8177
27067,"Minnesota","KANDIYOHI",7266,12785,927,164,630,21772
27069,"Minnesota","KITTSON",823,1349,121,15,77,2385
27071,"Minnesota","KOOCHICHING",2306,3569,207,69,212,6363
27073,"Minnesota","LAC QUI PARLE",1305,2293,106,33,123,3860
27075,"Minnesota","LAKE",3077,2932,215,93,204,6521
27077,"Minnesota","LAKE OF THE WOODS",553,1540,67,16,66,2242
27079,"Minnesota","LE SUEUR",4623,9182,514,146,506,14971
27081,"Minnesota","LINCOLN",860,1931,112,18,98,3019
27083,"Minnesota","LYON",3825,7256,523,115,496,12215
27085,"Minnesota","MCLEOD",4978,12155,857,135,682,18807
27087,"Minnesota","MAHNOMEN",930,991,54,34,79,2088
27089,"Minnesota","MARSHALL",1225,3208,204,30,150,4817
27091,"Minnesota","MARTIN",2733,7062,343,79,314,10531
27093,"Minnesota","MEEKER",3191,8104,448,94,445,12282
27095,"Minnesota","MILLE LACS",3710,8340,451,128,388,13017
27097,"Minnesota","MORRISON",3637,12925,442,146,464,17614
27099,"Minnesota","MOWER",7437,8823,620,191,644,17715
27101,"Minnesota","MURRAY",1295,2974,203,22,174,4668
27103,"Minnesota","NICOLLET",7886,8437,831,250,693,18097
27105,"Minnesota","NOBLES",2733,5299,258,40,302,8632
27107,"Minnesota","NORMAN",1264,1699,161,29,108,3261
27109,"Minnesota","OLMSTED",36268,35668,3547,1117,3529,80129
27111,"Minnesota","OTTER TAIL",9340,20939,1000,245,976,32500
27113,"Minnesota","PENNINGTON",2147,4000,315,46,207,6715
27115,"Minnesota","PINE",4580,8191,473,147,420,13811
27117,"Minnesota","PIPESTONE",1127,3338,131,44,168,4808
27119,"Minnesota","POLK",4712,8979,517,124,464,14796
27121,"Minnesota","POPE",2106,3793,221,43,156,6319
27123,"Minnesota","RAMSEY",177738,70894,9626,4560,10325,273143
27125,"Minnesota","RED LAKE",540,1141,100,23,77,1881
27127,"Minnesota","REDWOOD",1887,5137,242,77,268,7611
27129,"Minnesota","RENVILLE",2117,4890,244,66,289,7606
27131,"Minnesota","RICE",14437,15429,1230,386,961,32443
27133,"Minnesota","ROCK",1373,3091,155,40,180,4839
27135,"Minnesota","ROSEAU",1856,5451,220,42,235,7804
27137,"Minnesota","ST. LOUIS",57771,44630,4366,1878,3777,112422
27139,"Minnesota","SCOTT",28502,39948,3400,740,2439,75029
27141,"Minnesota","SHERBURNE",13293,31053,1927,457,1553,48283
27143,"Minnesota","SIBLEY",1954,5193,291,64,272,7774
27145,"Minnesota","STEARNS",25576,47617,2972,954,2473,79592
27147,"Minnesota","STEELE",6241,11198,808,208,724,19179
27149,"Minnesota","STEVENS",2116,2799,205,69,209,5398
27151,"Minnesota","SWIFT",1686,2963,153,33,159,4994
27153,"Minnesota","TODD",2783,8485,287,96,342,11993
27155,"Minnesota","TRAVERSE",630,1049,40,16,63,1798
27157,"Minnesota","WABASHA",3866,6989,467,127,383,11832
27159,"Minnesota","WADENA",1684,4837,164,58,191,6934
27161,"Minnesota","WASECA",2838,5967,387,106,355,9653
27163,"Minnesota","WASHINGTON",67086,64428,6180,1478,5063,144235
27165,"Minnesota","WATONWAN",1814,2768,156,52,208,4998
27167,"Minnesota","WILKIN",893,2129,146,34,100,3302
27169,"Minnesota","WINONA",11366,12122,1165,531,890,26074
27171,"Minnesota","WRIGHT",20334,43274,3002,547,2461,69618
27173,"Minnesota","YELLOW MEDICINE",1524,3382,163,37,170,5276
28001,"Mississippi","Adams",7757,5874,125,32,48,13836
28003,"Mississippi","Alcorn",2684,11819,167,38,75,14783
28005,"Mississippi","Amite",2697,4289,38,8,18,7050
28007,"Mississippi","Attala",3242,4897,57,17,43,8256
28009,"Mississippi","Benton",1719,2251,28,9,6,4013
28011,"Mississippi","Bolivar",9046,4590,100,38,50,13824
28013,"Mississippi","Calhoun",1910,4390,49,11,36,6396
28015,"Mississippi","Carroll",1680,3799,29,9,11,5528
28017,"Mississippi","Chickasaw",3649,4127,61,12,41,7890
28019,"Mississippi","Choctaw",1218,2788,26,12,21,4065
28021,"Mississippi","Caliborne",3708,540,7,5,12,4272
28023,"Mississippi","Clarke",2585,5137,29,15,25,7791
28025,"Mississippi","Clay",5722,4150,69,20,42,10003
28027,"Mississippi","Coahoma",6378,2426,53,13,42,8912
28029,"Mississippi","Coplah",6741,6103,73,16,49,12982
28031,"Mississippi","Covington",3276,5435,61,12,27,8811
28033,"Mississippi","DeSoto",20591,43089,1329,308,378,65695
28035,"Mississippi","Forrest",11716,15461,598,149,140,28064
28037,"Mississippi","Franklin",1502,2721,22,16,29,4290
28039,"Mississippi","George",1027,8696,91,20,57,9891
28041,"Mississippi","Greee",974,4335,28,4,28,5369
28043,"Mississippi","Grenada",4424,5970,69,22,28,10513
28045,"Mississippi","Hancock",3344,13811,312,83,87,17637
28047,"Mississippi","Harrison",21169,40354,1230,330,230,63313
28049,"Mississippi","Hinds",67594,25275,1013,470,329,94681
28051,"Mississippi","Holmes",6689,1309,25,19,34,8076
28053,"Mississippi","Humphreys",3071,1151,12,3,16,4253
28055,"Mississippi","Issaquena",395,298,4,0,2,699
28057,"Mississippi","Itawamba",1117,8470,84,20,46,9737
28059,"Mississippi","Jackson",14657,33629,901,162,218,49567
28061,"Mississippi","Jasper",4368,4038,28,6,35,8475
28063,"Mississippi","Jefferson",3337,490,13,7,13,3860
28065,"Mississippi","Jeff Davis",3720,2466,21,3,27,6237
28067,"Mississippi","Jones",7791,20133,268,53,107,28352
28069,"Mississippi","Kemper",2827,1778,18,1,15,4639
28071,"Mississippi","Lafayette",7969,10872,577,134,91,19643
28073,"Mississippi","Lamar",5190,18751,452,75,124,24592
28075,"Mississippi","Lauderdale",11269,17741,307,71,118,29506
28077,"Mississippi","Lawrence",2195,4091,40,15,23,6364
28079,"Mississippi","Leake",3584,4782,40,13,30,8449
28081,"Mississippi","Lee",10029,22220,405,121,138,32913
28083,"Mississippi","Leflore",7787,3212,78,25,38,11140
28085,"Mississippi","Lincoln",4458,10550,89,26,70,15193
28087,"Mississippi","Lowndes",11819,13271,295,95,95,25575
28089,"Mississippi","Madison",20343,28265,842,133,219,49802
28091,"Mississippi","Marion",3677,7836,107,32,41,11693
28093,"Mississippi","Marshall",8023,6587,95,55,79,14839
28095,"Mississippi","Monroe",5524,10167,110,28,55,15884
28097,"Mississippi","Montgomery",2115,2818,32,8,23,4996
28099,"Mississippi","Neshoba",2715,7679,83,20,56,10553
28101,"Mississippi","Newton",2756,6548,67,22,45,9438
28103,"Mississippi","Noxubee",4347,1200,12,6,9,5574
28105,"Mississippi","Okitbbeha",8859,8576,464,101,124,18124
28107,"Mississippi","Panola",7431,7449,96,20,68,15064
28109,"Mississippi","Pearl River",3604,17782,315,78,104,21883
28111,"Mississippi","Perry",1220,4135,47,5,25,5432
28113,"Mississippi","Pike",8043,8009,142,43,73,16310
28115,"Mississippi","Pontotoc",2386,10336,150,36,76,12984
28117,"Mississippi","Prentiss",2067,7648,79,25,53,9872
28119,"Mississippi","Quitman",2312,1001,20,7,25,3365
28121,"Mississippi","Rankin",14110,47178,967,218,295,62768
28123,"Mississippi","Scott",4268,6122,81,19,32,10522
28125,"Mississippi","Sharkey",1479,692,10,2,7,2190
28127,"Mississippi","Simpson",3874,7393,74,22,56,11419
28129,"Mississippi","Smith",1617,5928,51,8,23,7627
28131,"Mississippi","Stone",1573,5306,108,16,42,7045
28133,"Mississippi","Sunflower",6725,2794,27,20,32,9598
28135,"Mississippi","Tallahatchie",3337,2462,31,8,32,5870
28137,"Mississippi","Tate",3926,7495,115,20,71,11627
28139,"Mississippi","Tippah",1842,7240,72,22,59,9235
28141,"Mississippi","Tishomingo",999,7166,140,28,38,8371
28143,"Mississippi","Tunica",2667,853,18,8,21,3567
28145,"Mississippi","Union",2012,9235,133,20,96,11496
28147,"Mississippi","Walthall",2790,4056,31,10,32,6919
28149,"Mississippi","Warren",9284,9767,229,56,80,19416
28151,"Mississippi","Washington",11380,5244,106,35,60,16825
28153,"Mississippi","Wayne",3524,5990,46,3,36,9599
28155,"Mississippi","Webster",1019,3976,27,15,32,5069
28157,"Mississippi","Wilkinson",2857,1318,15,4,24,4218
28159,"Mississippi","Winston",3850,4910,55,30,36,8881
28161,"Mississippi","Yalobusha",2582,3376,70,24,25,6077
28163,"Mississippi","Yazoo",5369,4598,47,6,50,10070
29001,"Missouri","Adair",3500,6030,426,147,123,10226
29003,"Missouri","Andrew",2045,6665,336,64,30,9140
29005,"Missouri","Atchison",541,2060,104,14,11,2730
29007,"Missouri","Audrain",2570,6981,363,73,74,10061
29009,"Missouri","Barry",2710,11428,338,66,63,14605
29011,"Missouri","Barton",795,4959,135,22,28,5939
29013,"Missouri","Bates",1618,6001,306,55,51,8031
29015,"Missouri","Benton",2025,7213,278,41,33,9590
29017,"Missouri","Bollinger",705,4827,97,12,35,5676
29019,"Missouri","Boone",41125,36200,4268,1280,995,83868
29021,"Missouri","Buchanan",12013,21320,1709,343,274,35659
29023,"Missouri","Butler",3036,13650,392,98,83,17259
29025,"Missouri","Caldwell",838,3232,188,26,28,4312
29027,"Missouri","Callaway",4989,13057,757,182,208,19193
29029,"Missouri","Camden",4768,16944,597,110,95,22514
29031,"Missouri","Cape Girardeau",8492,27017,1109,239,181,37038
29033,"Missouri","Carroll",745,3480,106,17,13,4361
29035,"Missouri","Carter",436,2324,55,18,17,2850
29037,"Missouri","Cass",14846,33098,2159,420,467,50990
29039,"Missouri","Cedar",1011,5021,179,30,47,6288
29041,"Missouri","Chariton",888,2950,98,10,23,3969
29043,"Missouri","Christian",8508,30946,1495,245,337,41531
29045,"Missouri","Clark",724,2458,101,22,11,3316
29047,"Missouri","Clay",45304,57476,5155,1097,1144,110176
29049,"Missouri","Clinton",2572,7067,434,77,58,10208
29051,"Missouri","Cole",10913,24616,1377,254,214,37374
29053,"Missouri","Cooper",1932,5624,306,58,66,7986
29055,"Missouri","Crawford",1824,7724,224,91,57,9920
29057,"Missouri","Dade",637,3184,94,16,20,3951
29059,"Missouri","Dallas",1272,5895,181,49,56,7453
29061,"Missouri","Daviess",730,2767,145,18,78,3738
29063,"Missouri","De Kalb",824,3540,178,30,22,4594
29065,"Missouri","Dent",978,5600,136,36,41,6791
29067,"Missouri","Douglas",984,5486,135,21,40,6666
29069,"Missouri","Dunklin",2360,8026,142,30,20,10578
29071,"Missouri","Franklin",12341,35430,1628,428,286,50113
29073,"Missouri","Gasconade",1520,5670,180,47,34,7451
29075,"Missouri","Gentry",605,2304,108,9,17,3043
29077,"Missouri","Greene",42728,78035,5754,1465,1249,129231
29079,"Missouri","Grundy",780,3462,118,28,40,4428
29081,"Missouri","Harrison",574,2965,97,19,34,3689
29083,"Missouri","Henry",2357,7075,311,61,62,9866
29085,"Missouri","Hickory",1016,3542,108,31,27,4724
29087,"Missouri","Holt",347,1926,66,6,10,2355
29089,"Missouri","Howard",1283,3277,209,41,58,4868
29091,"Missouri","Howell",2881,13893,434,132,115,17455
29093,"Missouri","Iron",933,3173,110,30,23,4269
29095,"Missouri","Jackson",71237,91557,7128,1799,1554,173275
29097,"Missouri","Jasper",10572,35070,1761,484,439,48326
29099,"Missouri","Jefferson",31568,69036,3968,930,736,106238
29101,"Missouri","Johnson",5930,13719,1100,205,178,21132
29103,"Missouri","Knox",379,1416,53,12,10,1870
29105,"Missouri","Laclede",2553,12881,426,87,104,16051
29107,"Missouri","Lafayette",4053,10988,598,92,145,15876
29109,"Missouri","Lawrence",2901,13089,472,104,149,16715
29111,"Missouri","Lewis",934,3344,127,26,25,4456
29113,"Missouri","Lincoln",5575,18159,808,198,222,24962
29115,"Missouri","Linn",1240,4088,172,54,33,5587
29117,"Missouri","Livingston",1265,4879,213,20,44,6421
29119,"Missouri","McDonald",1329,6599,191,70,53,8242
29121,"Missouri","Macon",1548,5798,175,57,53,7631
29123,"Missouri","Madison",1005,4102,150,30,34,5321
29125,"Missouri","Maries",794,3561,110,23,12,4500
29127,"Missouri","Marion",2994,9419,380,63,82,12938
29129,"Missouri","Mercer",216,1486,27,2,14,1745
29131,"Missouri","Miller",1750,9285,283,58,40,11416
29133,"Missouri","Mississippi",1458,3600,79,15,17,5169
29135,"Missouri","Moniteau",1237,5347,177,26,43,6830
29137,"Missouri","Monroe",853,3159,114,13,17,4156
29139,"Missouri","Montgomery",1119,4127,134,32,17,5429
29141,"Missouri","Morgan",1768,6760,202,51,40,8821
29143,"Missouri","New Madrid",1933,5270,106,24,24,7357
29145,"Missouri","Newton",4990,20553,641,168,254,26606
29147,"Missouri","Nodaway",2529,6380,401,61,87,9458
29149,"Missouri","Oregon",865,3671,88,14,30,4668
29151,"Missouri","Osage",998,5856,182,34,20,7090
29153,"Missouri","Ozark",724,3639,70,41,31,4505
29155,"Missouri","Pemiscot",1947,3964,79,21,16,6027
29157,"Missouri","Perry",1520,6908,231,39,42,8740
29159,"Missouri","Pettis",4324,12810,735,112,130,18111
29161,"Missouri","Phelps",4766,12709,750,198,130,18553
29163,"Missouri","Pike",1806,5274,208,50,44,7382
29165,"Missouri","Platte",20057,25933,2271,426,413,49100
29167,"Missouri","Polk",2631,10438,479,77,138,13763
29169,"Missouri","Pulaski",2922,9876,485,106,99,13488
29171,"Missouri","Putnam",353,1936,36,13,8,2346
29173,"Missouri","Ralls",1138,3969,120,17,22,5266
29175,"Missouri","Randolph",2283,7529,392,60,45,10309
29177,"Missouri","Ray",3090,7104,509,61,105,10869
29179,"Missouri","Reynolds",540,2406,62,21,9,3038
29181,"Missouri","Ripley",830,4522,115,35,22,5524
29183,"Missouri","St. Charles",68626,121650,7964,1698,1067,201005
29185,"Missouri","St. Clair",936,3501,146,24,23,4630
29186,"Missouri","Ste. Genevieve",2542,5496,324,56,51,8469
29187,"Missouri","St. Francois",6250,17468,712,171,127,24728
29189,"Missouri","St. Louis",286704,202434,16677,5207,3836,514858
29195,"Missouri","Saline",2789,5977,383,69,56,9274
29197,"Missouri","Schuyler",354,1505,64,7,6,1936
29199,"Missouri","Scotland",365,1525,50,18,10,1968
29201,"Missouri","Scott",3575,13168,374,79,60,17256
29203,"Missouri","Shannon",776,2966,106,28,28,3904
29205,"Missouri","Shelby",606,2524,92,16,17,3255
29207,"Missouri","Stoddard",1876,11079,238,45,53,13291
29209,"Missouri","Stone",2887,13158,383,59,80,16567
29211,"Missouri","Sullivan",526,1884,58,9,9,2486
29213,"Missouri","Taney",4373,18276,525,129,212,23515
29215,"Missouri","Texas",1728,8875,222,52,79,10956
29217,"Missouri","Vernon",1707,6533,236,67,56,8599
29219,"Missouri","Warren",3915,11111,534,116,108,15784
29221,"Missouri","Washington",1926,7048,197,60,51,9282
29223,"Missouri","Wayne",948,4658,107,29,20,5762
29225,"Missouri","Webster",3177,12840,515,85,126,16743
29227,"Missouri","Worth",195,808,32,5,6,1046
29229,"Missouri","Wright",1170,6707,153,22,67,8119
29510,"Missouri","St. Louis City",104235,20832,3518,2005,601,131191
30001,"Montana","Beaverhead",1143,3353,265,70,18,4849
30003,"Montana","Big Horn",2094,1853,185,71,21,4224
30005,"Montana","Blaine",1202,1268,102,73,26,2671
30007,"Montana","Broadwater",573,2348,169,37,5,3132
30009,"Montana","Carbon",1828,3748,307,70,14,5967
30011,"Montana","Carter",70,678,24,6,1,779
30013,"Montana","Cascade",12175,19632,1996,446,135,34384
30015,"Montana","Chouteau",732,1679,131,37,10,2589
30017,"Montana","Custer",1176,3657,302,35,15,5185
30019,"Montana","Daniels",168,730,51,6,0,955
30021,"Montana","Dawson",787,3320,184,33,7,4331
30023,"Montana","Deer Lodge",2058,1763,276,74,23,4194
30025,"Montana","Fallon",154,1279,45,4,2,1484
30027,"Montana","Fergus",1202,4269,302,52,15,5840
30029,"Montana","Flathead",13293,30240,2199,656,106,46494
30031,"Montana","Gallatin",24246,23802,4015,1061,168,53292
30033,"Montana","Garfield",34,653,27,1,1,716
30035,"Montana","Glacier",3121,1620,203,95,22,5061
30037,"Montana","Golden Valley",71,365,29,3,3,471
30039,"Montana","Granite",472,1192,83,25,3,1775
30041,"Montana","Hill",2371,3478,438,118,21,6426
30043,"Montana","Jefferson",1998,4177,394,75,24,6668
30045,"Montana","Judith Basin",235,872,79,12,3,1201
30047,"Montana","Lake",4776,7530,534,229,41,13110
30049,"Montana","Lewis & Clark",14478,16895,2210,559,103,34245
30051,"Montana","Liberty",206,698,47,2,3,956
30053,"Montana","Lincoln",2041,6729,396,96,22,9284
30055,"Montana","McCone",154,862,37,7,0,1060
30057,"Montana","Madison",1180,3297,195,58,13,4743
30059,"Montana","Meagher",193,729,41,10,2,975
30061,"Montana","Mineral",519,1330,108,35,11,2003
30063,"Montana","Missoula",31543,22250,3357,1704,172,59026
30065,"Montana","Musselshell",332,1967,94,18,5,2416
30067,"Montana","Park",3595,4980,500,200,31,9306
30069,"Montana","Petroleum",30,278,12,1,1,322
30071,"Montana","Phillips",318,1723,99,19,2,2161
30073,"Montana","Pondera",738,1799,135,34,10,2716
30075,"Montana","Powder River",127,884,39,1,0,1051
30077,"Montana","Powell",551,2029,163,41,10,2794
30079,"Montana","Prairie",100,556,30,1,2,689
30081,"Montana","Ravalli",6223,14810,992,261,60,22346
30083,"Montana","Richland",671,3908,239,23,6,4847
30085,"Montana","Roosevelt",1560,1797,180,95,16,3648
30087,"Montana","Rosebud",987,2253,152,33,15,3440
30089,"Montana","Sanders",1218,4286,299,94,13,5910
30091,"Montana","Sheridan",477,1241,92,20,2,1832
30093,"Montana","Silver Bow",8619,6376,1057,293,94,16439
30095,"Montana","Stillwater",908,3661,251,35,11,4866
30097,"Montana","Sweet Grass",402,1595,77,23,3,2100
30099,"Montana","Teton",808,2170,162,27,12,3179
30101,"Montana","Toole",402,1497,96,29,6,2030
30103,"Montana","Treasure",59,351,26,6,1,443
30105,"Montana","Valley",886,2698,234,44,14,3876
30107,"Montana","Wheatland",179,702,43,14,6,944
30109,"Montana","Wibaux",55,463,18,0,1,537
30111,"Montana","Yellowstone",22171,40920,4316,898,239,68544
31001,"Nebraska","Adams",3302,9287,594,111,219,13513
31003,"Nebraska","Antelope",383,2732,105,19,42,3281
31005,"Nebraska","Arthur",17,244,11,0,1,273
31007,"Nebraska","Banner",19,357,14,3,9,402
31009,"Nebraska","Blaine",30,276,10,0,1,317
31011,"Nebraska","Boone",414,2299,137,17,38,2905
31013,"Nebraska","Box Butte",965,3617,230,36,76,4924
31015,"Nebraska","Boyd",128,983,23,13,9,1156
31017,"Nebraska","Brown",153,1385,39,7,13,1597
31019,"Nebraska","Buffalo",4763,14569,1174,227,396,21129
31021,"Nebraska","Burt",930,2367,197,39,25,3558
31023,"Nebraska","Butler",691,3079,129,27,55,3981
31025,"Nebraska","Cass",3484,8452,639,132,226,12933
31027,"Nebraska","Cedar",571,3532,224,31,62,4420
31029,"Nebraska","Chase",171,1648,54,6,19,1898
31031,"Nebraska","Cherry",317,2623,127,15,36,3118
31033,"Nebraska","Cheyenne",711,3665,213,46,76,4711
31035,"Nebraska","Clay",477,2422,116,15,35,3065
31037,"Nebraska","Colfax",859,2171,118,26,40,3214
31039,"Nebraska","Cuming",719,3122,157,26,50,4074
31041,"Nebraska","Custer",641,4695,206,37,73,5652
31043,"Nebraska","Dakota",2314,3616,229,50,70,6279
31045,"Nebraska","Dawes",801,2632,191,52,0,3676
31047,"Nebraska","Dawson",2136,5984,381,58,76,8635
31049,"Nebraska","Deuel",120,809,47,1,7,984
31051,"Nebraska","Dixon",556,2041,130,17,38,2782
31053,"Nebraska","Dodge",4544,9933,624,162,266,15529
31055,"Nebraska","Douglas",113798,108077,10402,2882,5274,240433
31057,"Nebraska","Dundy",89,823,31,6,4,953
31059,"Nebraska","Fillmore",613,2130,151,21,26,2941
31061,"Nebraska","Franklin",250,1347,54,7,15,1673
31063,"Nebraska","Frontier",161,1110,36,8,13,1328
31065,"Nebraska","Furnas",304,1921,85,11,19,2340
31067,"Nebraska","Gage",2935,6380,492,104,137,10048
31069,"Nebraska","Garden",153,869,39,2,12,1075
31071,"Nebraska","Garfield",121,821,23,5,10,980
31073,"Nebraska","Gosper",166,794,38,6,6,1010
31075,"Nebraska","Grant",20,367,6,1,11,405
31077,"Nebraska","Greeley",210,912,38,6,9,1175
31079,"Nebraska","Hall",6282,14408,895,192,283,22060
31081,"Nebraska","Hamilton",878,3783,224,43,76,5004
31083,"Nebraska","Harlan",254,1496,62,7,13,1832
31085,"Nebraska","Hayes",30,472,8,1,3,514
31087,"Nebraska","Hitchcock",161,1232,61,7,7,1468
31089,"Nebraska","Holt",531,4354,162,27,44,5118
31091,"Nebraska","Hooker",40,355,16,3,3,417
31093,"Nebraska","Howard",544,2284,108,22,36,2994
31095,"Nebraska","Jefferson",837,2399,182,30,46,3494
31097,"Nebraska","Johnson",563,1355,122,22,27,2089
31099,"Nebraska","Kearney",550,2531,148,26,41,3296
31101,"Nebraska","Keith",571,3235,164,25,39,4034
31103,"Nebraska","Keya Paha",40,460,17,0,2,519
31105,"Nebraska","Kimball",230,1330,78,18,21,1677
31107,"Nebraska","Knox",720,3188,137,29,41,4115
31109,"Nebraska","Lancaster",61898,61588,7109,1974,3654,136223
31111,"Nebraska","Lincoln",2913,12164,711,107,236,16131
31113,"Nebraska","Logan",32,400,18,1,2,453
31115,"Nebraska","Loup",48,323,10,1,3,385
31117,"Nebraska","McPherson",14,257,14,1,1,287
31119,"Nebraska","Madison",2711,10628,669,126,209,14343
31121,"Nebraska","Merrick",602,2926,165,29,66,3788
31123,"Nebraska","Morrill",284,1802,84,14,25,2209
31125,"Nebraska","Nance",281,1261,48,14,17,1621
31127,"Nebraska","Nemaha",785,2116,180,27,53,3161
31129,"Nebraska","Nuckolls",353,1726,88,20,18,2205
31131,"Nebraska","Otoe",2025,4860,375,58,139,7457
31133,"Nebraska","Pawnee",279,974,55,10,9,1327
31135,"Nebraska","Perkins",161,1217,54,5,18,1455
31137,"Nebraska","Phelps",572,3849,190,18,66,4695
31139,"Nebraska","Pierce",382,3052,125,21,50,3630
31141,"Nebraska","Platte",2646,10965,495,86,241,14433
31143,"Nebraska","Polk",413,2028,102,6,33,2582
31145,"Nebraska","Red Willow",645,4258,191,26,50,5170
31147,"Nebraska","Richardson",818,2769,159,27,32,3805
31149,"Nebraska","Rock",70,687,33,4,4,798
31151,"Nebraska","Saline",1733,3004,284,52,63,5136
31153,"Nebraska","Sarpy",28033,45143,4682,836,1886,80580
31155,"Nebraska","Saunders",2523,7555,515,97,170,10860
31157,"Nebraska","Scotts Bluff",3207,10076,683,126,225,14317
31159,"Nebraska","Seward",1875,5454,337,84,172,7922
31161,"Nebraska","Sheridan",287,2211,70,18,22,2608
31163,"Nebraska","Sherman",340,1150,59,13,11,1573
31165,"Nebraska","Sioux",81,616,28,4,7,736
31167,"Nebraska","Stanton",417,2187,144,14,39,2801
31169,"Nebraska","Thayer",499,2051,124,10,6,2690
31171,"Nebraska","Thomas",30,344,10,3,6,393
31173,"Nebraska","Thurston",919,1043,56,49,21,2088
31175,"Nebraska","Valley",339,1780,53,12,21,2205
31177,"Nebraska","Washington",2623,7424,513,97,175,10832
31179,"Nebraska","Wayne",835,2693,202,35,11,3776
31181,"Nebraska","Webster",306,1330,51,10,11,1708
31183,"Nebraska","Wheeler",62,377,17,4,5,465
31185,"Nebraska","York",1186,4700,345,52,98,6381
32001,"Nevada","Churchill",2210,7830,450,NA,448,10938
32003,"Nevada","Clark",402227,320057,22453,NA,22419,767156
32005,"Nevada","Douglas",8454,17415,1004,NA,1012,27885
32007,"Nevada","Elko",3401,13551,828,NA,779,18559
32009,"Nevada","Esmeralda",65,329,15,NA,14,423
32011,"Nevada","Eureka",74,723,19,NA,38,854
32013,"Nevada","Humboldt",1386,4521,269,NA,257,6433
32015,"Nevada","Lander",403,1828,79,NA,103,2413
32017,"Nevada","Lincoln",285,1671,62,NA,114,2132
32019,"Nevada","Lyon",6146,16005,813,NA,798,23762
32021,"Nevada","Mineral",637,1179,88,NA,93,1997
32023,"Nevada","Nye",5094,13324,552,NA,625,19595
32027,"Nevada","Pershing",430,1403,58,NA,91,1982
32029,"Nevada","Storey",752,1616,100,NA,90,2558
32031,"Nevada","Washoe",97379,94758,9284,NA,8488,209909
32033,"Nevada","White Pine",707,2723,151,NA,192,3773
32510,"Nevada","Carson City",9610,13125,1159,NA,1122,25016
33001,"New Hampshire","Alton",1152,2201,115,24,2,3494
33001,"New Hampshire","Barnstead",924,1520,125,20,0,2589
33001,"New Hampshire","Belmont",1272,2192,158,28,7,3657
33001,"New Hampshire","Center Harbor",324,357,23,8,1,713
33001,"New Hampshire","Gilford",1973,2504,159,31,1,4668
33001,"New Hampshire","Gilmanton",788,1333,108,21,1,2251
33001,"New Hampshire","Laconia Ward 1",621,868,68,9,0,1566
33001,"New Hampshire","Laconia Ward 2",469,612,46,7,3,1137
33001,"New Hampshire","Laconia Ward 3",637,604,49,12,0,1302
33001,"New Hampshire","Laconia Ward 4",490,632,53,19,3,1197
33001,"New Hampshire","Laconia Ward 5",416,561,44,11,2,1034
33001,"New Hampshire","Laconia Ward 6",670,1026,71,14,6,1787
33001,"New Hampshire","Meredith",1709,2160,156,29,5,4059
33001,"New Hampshire","New Hampton",544,737,69,10,0,1360
33001,"New Hampshire","Sanbornton",748,1035,76,34,2,1895
33001,"New Hampshire","Tilton",780,973,75,19,2,1849
33003,"New Hampshire","Albany",195,182,13,7,2,399
33003,"New Hampshire","Bartlett",1094,730,84,21,0,1929
33003,"New Hampshire","Brookfield",156,262,25,3,1,447
33003,"New Hampshire","Chatham",79,103,19,3,0,204
33003,"New Hampshire","Conway",2717,2204,209,57,2,5189
33003,"New Hampshire","Eaton",157,109,14,2,0,282
33003,"New Hampshire","Effingham",317,481,38,6,0,842
33003,"New Hampshire","Freedom",425,476,36,14,1,952
33003,"New Hampshire","Hale's Location",26,97,0,0,0,123
33003,"New Hampshire","Hart's Location",17,14,3,0,0,34
33003,"New Hampshire","Jackson",430,212,28,5,0,675
33003,"New Hampshire","Madison",721,654,70,13,5,1463
33003,"New Hampshire","Moultonborough",1148,1888,126,16,0,3178
33003,"New Hampshire","Ossipee",770,1294,94,18,2,2178
33003,"New Hampshire","Sandwich",578,360,34,13,1,986
33003,"New Hampshire","Tamworth",739,761,69,24,2,1595
33003,"New Hampshire","Tuftonboro",674,891,55,17,0,1637
33003,"New Hampshire","Wakefield",873,1741,111,20,0,2745
33003,"New Hampshire","Wolfeboro",1871,2176,157,36,4,4244
33005,"New Hampshire","Alstead",522,444,37,20,1,1024
33005,"New Hampshire","Chesterfield",1166,910,71,11,3,2161
33005,"New Hampshire","Dublin",598,370,40,6,2,1016
33005,"New Hampshire","Fitzwilliam",577,623,52,0,0,1252
33005,"New Hampshire","Gilsum",197,231,13,9,0,450
33005,"New Hampshire","Harrisville",446,202,21,7,1,677
33005,"New Hampshire","Hinsdale",917,733,47,21,4,1722
33005,"New Hampshire","Jaffrey",1311,1284,150,39,5,2789
33005,"New Hampshire","Keene Ward 1",1462,640,97,46,3,2248
33005,"New Hampshire","Keene Ward 2",1648,692,86,40,4,2470
33005,"New Hampshire","Keene Ward 3",1424,736,84,32,1,2277
33005,"New Hampshire","Keene Ward 4",1581,791,87,42,0,2501
33005,"New Hampshire","Keene Ward 5",1817,972,107,38,2,2936
33005,"New Hampshire","Marlborough",711,408,34,10,2,1165
33005,"New Hampshire","Marlow",219,200,19,2,1,441
33005,"New Hampshire","Nelson",259,138,17,9,0,423
33005,"New Hampshire","Richmond",269,357,34,5,0,665
33005,"New Hampshire","Rindge",1292,1961,163,24,4,3444
33005,"New Hampshire","Roxbury",72,58,6,3,0,139
33005,"New Hampshire","Stoddard",350,378,28,8,1,765
33005,"New Hampshire","Sullivan",196,172,25,3,0,396
33005,"New Hampshire","Surry",237,244,14,4,0,499
33005,"New Hampshire","Swanzey",1807,1828,144,34,3,3816
33005,"New Hampshire","Troy",422,509,60,8,0,999
33005,"New Hampshire","Walpole",1169,755,104,27,3,2058
33005,"New Hampshire","Westmoreland",555,411,41,11,1,1019
33005,"New Hampshire","Winchester",840,829,75,25,0,1769
33007,"New Hampshire","Berlin",1954,1766,156,34,7,3917
33007,"New Hampshire","Cambridge",1,1,0,0,0,2
33007,"New Hampshire","Carroll",213,245,9,6,0,473
33007,"New Hampshire","Clarksville",68,95,5,4,0,172
33007,"New Hampshire","Colebrook",359,593,51,13,3,1019
33007,"New Hampshire","Columbia",109,219,13,2,0,343
33007,"New Hampshire","Dalton",192,280,18,5,0,495
33007,"New Hampshire","Dixville",4,2,1,0,0,7
33007,"New Hampshire","Dummer",65,99,6,2,0,172
33007,"New Hampshire","Errol",54,135,6,0,0,195
33007,"New Hampshire","Gorham",770,693,58,11,1,1533
33007,"New Hampshire","Green's Grant",1,0,0,0,0,1
33007,"New Hampshire","Jefferson",216,357,24,5,0,602
33007,"New Hampshire","Lancaster",657,841,58,23,4,1583
33007,"New Hampshire","Milan",298,414,24,8,0,744
33007,"New Hampshire","Millsfield",4,16,0,0,0,20
33007,"New Hampshire","Northumberland",387,539,42,18,4,990
33007,"New Hampshire","Pinkham's Grant",3,0,0,0,0,3
33007,"New Hampshire","Pittsburg",121,343,5,3,0,472
33007,"New Hampshire","Randolph",160,79,7,2,1,249
33007,"New Hampshire","Shelburne",125,116,10,0,0,251
33007,"New Hampshire","Stark",98,186,6,3,0,293
33007,"New Hampshire","Stewartstown",95,231,19,4,1,350
33007,"New Hampshire","Stratford",132,126,5,3,0,266
33007,"New Hampshire","Wentworth's Location",5,13,0,0,0,18
33007,"New Hampshire","Whitefield",472,563,53,24,2,1114
33009,"New Hampshire","Alexandria",343,546,42,10,0,941
33009,"New Hampshire","Ashland",504,520,47,11,1,1083
33009,"New Hampshire","Bath",211,292,27,5,0,535
33009,"New Hampshire","Benton",72,105,6,5,0,188
33009,"New Hampshire","Bethlehem",796,573,48,24,0,1441
33009,"New Hampshire","Bridgewater",267,423,24,4,0,718
33009,"New Hampshire","Bristol",626,900,74,21,4,1625
33009,"New Hampshire","Campton",890,870,88,20,3,1871
33009,"New Hampshire","Canaan",938,850,65,26,2,1881
33009,"New Hampshire","Dorchester",51,136,15,12,0,214
33009,"New Hampshire","Easton",118,65,7,3,0,193
33009,"New Hampshire","Ellsworth",26,24,5,2,0,57
33009,"New Hampshire","Enfield",1445,931,119,25,1,2521
33009,"New Hampshire","Franconia",483,233,18,9,0,743
33009,"New Hampshire","Grafton",267,397,33,8,1,706
33009,"New Hampshire","Groton",112,196,13,2,0,323
33009,"New Hampshire","Hanover",6561,926,189,50,1,7727
33009,"New Hampshire","Haverhill",785,1186,106,21,4,2102
33009,"New Hampshire","Hebron",175,238,13,2,0,428
33009,"New Hampshire","Holderness",704,546,43,9,4,1306
33009,"New Hampshire","Landaff",105,127,9,1,5,247
33009,"New Hampshire","Lebanon Ward 1",1670,578,71,27,3,2349
33009,"New Hampshire","Lebanon Ward 2",1542,606,74,40,2,2264
33009,"New Hampshire","Lebanon Ward 3",1686,657,94,39,3,2479
33009,"New Hampshire","Lincoln",408,367,45,13,2,835
33009,"New Hampshire","Lisbon",262,395,35,6,1,699
33009,"New Hampshire","Littleton",1241,1436,120,36,0,2833
33009,"New Hampshire","Lyman",126,169,14,4,0,313
33009,"New Hampshire","Lyme",890,232,32,11,1,1166
33009,"New Hampshire","Monroe",173,291,20,5,0,489
33009,"New Hampshire","Orange",73,85,6,2,0,166
33009,"New Hampshire","Orford",417,256,30,14,2,719
33009,"New Hampshire","Piermont",179,175,24,3,0,381
33009,"New Hampshire","Plymouth",2143,1394,191,58,8,3794
33009,"New Hampshire","Rumney",365,457,36,12,1,871
33009,"New Hampshire","Sugar Hill",237,159,15,10,0,421
33009,"New Hampshire","Thornton",736,651,88,14,0,1489
33009,"New Hampshire","Warren",180,261,14,5,0,460
33009,"New Hampshire","Waterville Valley",150,99,8,1,1,259
33009,"New Hampshire","Wentworth",175,323,16,5,0,519
33009,"New Hampshire","Woodstock",378,335,43,3,0,759
33011,"New Hampshire","Amherst",3777,3271,252,47,4,7351
33011,"New Hampshire","Antrim",668,748,71,13,12,1512
33011,"New Hampshire","Bedford",5851,6816,536,58,6,13267
33011,"New Hampshire","Bennington",327,422,41,8,2,800
33011,"New Hampshire","Brookline",1417,1501,170,32,3,3123
33011,"New Hampshire","Deering",383,586,55,10,1,1035
33011,"New Hampshire","Francestown",471,444,28,20,0,963
33011,"New Hampshire","Goffstown",4146,5009,412,57,7,9631
33011,"New Hampshire","Greenfield",433,414,52,13,0,912
33011,"New Hampshire","Greenville",379,493,46,11,9,938
33011,"New Hampshire","Hancock",713,433,39,6,5,1196
33011,"New Hampshire","Hillsborough",1198,1588,153,25,2,2966
33011,"New Hampshire","Hollis",2529,2310,251,47,1,5138
33011,"New Hampshire","Hudson",5306,7220,545,96,16,13183
33011,"New Hampshire","Litchfield",1923,2720,227,36,4,4910
33011,"New Hampshire","Lyndeborough",470,503,64,14,9,1060
33011,"New Hampshire","Manchester Ward 1",2988,2231,215,39,4,5477
33011,"New Hampshire","Manchester Ward 10",1990,1844,188,28,1,4051
33011,"New Hampshire","Manchester Ward 11",1695,1378,163,40,8,3284
33011,"New Hampshire","Manchester Ward 12",2149,1910,177,45,5,4286
33011,"New Hampshire","Manchester Ward 2",2461,1976,212,46,1,4696
33011,"New Hampshire","Manchester Ward 3",1834,983,130,33,4,2984
33011,"New Hampshire","Manchester Ward 4",1875,1372,170,47,1,3465
33011,"New Hampshire","Manchester Ward 5",1571,1078,142,38,4,2833
33011,"New Hampshire","Manchester Ward 6",2220,2493,193,32,8,4946
33011,"New Hampshire","Manchester Ward 7",1962,1700,148,39,7,3856
33011,"New Hampshire","Manchester Ward 8",2144,2633,180,35,8,5000
33011,"New Hampshire","Manchester Ward 9",2052,1956,163,32,5,4208
33011,"New Hampshire","Mason",306,477,65,6,1,855
33011,"New Hampshire","Merrimack",6405,7397,734,103,14,14653
33011,"New Hampshire","Milford",3816,3850,398,73,5,8142
33011,"New Hampshire","Mont Vernon",757,686,71,12,0,1526
33011,"New Hampshire","Nashua Ward 1",2946,2487,232,47,6,5718
33011,"New Hampshire","Nashua Ward 2",2483,1977,200,33,3,4696
33011,"New Hampshire","Nashua Ward 3",2482,1769,201,41,3,4496
33011,"New Hampshire","Nashua Ward 4",2077,1117,135,30,4,3363
33011,"New Hampshire","Nashua Ward 5",2752,2573,239,49,3,5616
33011,"New Hampshire","Nashua Ward 6",2307,1701,149,40,5,4202
33011,"New Hampshire","Nashua Ward 7",2171,1692,163,31,4,4061
33011,"New Hampshire","Nashua Ward 8",2688,2002,219,41,3,4953
33011,"New Hampshire","Nashua Ward 9",2784,2158,184,38,6,5170
33011,"New Hampshire","New Boston",1381,1792,161,23,3,3360
33011,"New Hampshire","New Ipswich",769,1894,138,14,3,2818
33011,"New Hampshire","Pelham",2719,4624,254,52,4,7653
33011,"New Hampshire","Peterborough",2487,1179,170,55,1,3892
33011,"New Hampshire","Sharon",132,94,11,4,0,241
33011,"New Hampshire","Temple",405,400,32,16,8,861
33011,"New Hampshire","Weare",1734,2957,281,62,8,5042
33011,"New Hampshire","Wilton",1028,1061,108,34,1,2232
33011,"New Hampshire","Windsor",28,94,2,1,0,125
33013,"New Hampshire","Allenstown",874,1203,97,17,0,2191
33013,"New Hampshire","Andover",703,673,49,7,2,1434
33013,"New Hampshire","Boscawen",833,929,83,16,0,1861
33013,"New Hampshire","Bow",2570,2119,218,28,2,4937
33013,"New Hampshire","Bradford",442,485,41,15,0,983
33013,"New Hampshire","Canterbury",815,671,58,20,1,1565
33013,"New Hampshire","Chichester",646,851,75,7,0,1579
33013,"New Hampshire","Concord Ward 1",1266,939,114,37,4,2360
33013,"New Hampshire","Concord Ward 10",1571,1120,110,17,2,2820
33013,"New Hampshire","Concord Ward 2",1084,897,90,24,2,2097
33013,"New Hampshire","Concord Ward 3",923,538,73,14,5,1553
33013,"New Hampshire","Concord Ward 4",1334,610,83,28,2,2057
33013,"New Hampshire","Concord Ward 5",1789,674,75,22,0,2560
33013,"New Hampshire","Concord Ward 6",1137,624,99,32,3,1895
33013,"New Hampshire","Concord Ward 7",1675,801,82,37,1,2596
33013,"New Hampshire","Concord Ward 8",1069,888,71,18,0,2046
33013,"New Hampshire","Concord Ward 9",1136,721,58,15,3,1933
33013,"New Hampshire","Danbury",247,386,30,16,0,679
33013,"New Hampshire","Dunbarton",681,1026,69,9,2,1787
33013,"New Hampshire","Epsom",919,1546,127,21,2,2615
33013,"New Hampshire","Franklin Ward 1",479,780,61,8,0,1328
33013,"New Hampshire","Franklin Ward 2",391,512,60,17,1,981
33013,"New Hampshire","Franklin Ward 3",617,757,49,15,2,1440
33013,"New Hampshire","Henniker",1429,1060,134,38,2,2663
33013,"New Hampshire","Hill",176,341,17,5,0,539
33013,"New Hampshire","Hooksett",3436,4225,292,53,4,8010
33013,"New Hampshire","Hopkinton",2240,1427,138,38,2,3845
33013,"New Hampshire","Loudon",1136,1950,146,12,3,3247
33013,"New Hampshire","Newbury",621,662,61,5,0,1349
33013,"New Hampshire","New London",1807,1101,95,24,0,3027
33013,"New Hampshire","Northfield",884,1330,105,29,4,2352
33013,"New Hampshire","Pembroke",1810,1919,179,33,5,3946
33013,"New Hampshire","Pittsfield",691,1125,99,19,1,1935
33013,"New Hampshire","Salisbury",288,490,25,9,0,812
33013,"New Hampshire","Sutton",607,560,52,13,2,1234
33013,"New Hampshire","Warner",874,790,83,31,1,1779
33013,"New Hampshire","Webster",499,602,40,3,2,1146
33013,"New Hampshire","Wilmot",499,342,40,1,1,883
33015,"New Hampshire","Atkinson",1671,2595,159,31,4,4460
33015,"New Hampshire","Auburn",1307,2031,145,22,3,3508
33015,"New Hampshire","Brentwood",1145,1267,121,19,3,2555
33015,"New Hampshire","Candia",855,1553,131,15,0,2554
33015,"New Hampshire","Chester",1092,1727,125,13,1,2958
33015,"New Hampshire","Danville",860,1580,102,20,3,2565
33015,"New Hampshire","Deerfield",1091,1607,138,14,3,2853
33015,"New Hampshire","Derry",6825,9237,715,123,13,16913
33015,"New Hampshire","East Kingston",608,830,88,9,2,1537
33015,"New Hampshire","Epping",1625,2117,179,35,3,3959
33015,"New Hampshire","Exeter",5514,3286,373,72,3,9248
33015,"New Hampshire","Fremont",965,1591,137,14,2,2709
33015,"New Hampshire","Greenland",1396,1074,101,13,3,2587
33015,"New Hampshire","Hampstead",1966,3186,191,42,3,5388
33015,"New Hampshire","Hampton",4953,4802,333,68,5,10161
33015,"New Hampshire","Hampton Falls",672,822,63,9,0,1566
33015,"New Hampshire","Kensington",642,668,61,11,0,1382
33015,"New Hampshire","Kingston",1422,2081,154,31,1,3689
33015,"New Hampshire","Londonderry",5968,7338,647,81,15,14049
33015,"New Hampshire","New Castle",481,279,31,6,0,797
33015,"New Hampshire","Newfields",603,474,45,11,0,1133
33015,"New Hampshire","Newington",271,292,23,4,0,590
33015,"New Hampshire","Newmarket",3157,1836,291,70,10,5364
33015,"New Hampshire","Newton",991,1593,114,15,4,2717
33015,"New Hampshire","North Hampton",1562,1448,104,23,0,3137
33015,"New Hampshire","Northwood",1056,1385,127,12,1,2581
33015,"New Hampshire","Nottingham",1365,1511,165,30,2,3073
33015,"New Hampshire","Plaistow",1672,2531,154,39,3,4399
33015,"New Hampshire","Portsmouth Ward 1",1839,789,115,28,2,2773
33015,"New Hampshire","Portsmouth Ward 2",2296,678,113,31,1,3119
33015,"New Hampshire","Portsmouth Ward 3",1528,779,87,11,0,2405
33015,"New Hampshire","Portsmouth Ward 4",1374,812,78,23,4,2291
33015,"New Hampshire","Portsmouth Ward 5",1874,574,114,19,0,2581
33015,"New Hampshire","Raymond",1921,3151,224,49,3,5348
33015,"New Hampshire","Rye",2211,1579,165,24,1,3980
33015,"New Hampshire","Salem",6068,9312,503,92,11,15986
33015,"New Hampshire","Sandown",1207,2144,178,23,5,3557
33015,"New Hampshire","Seabrook",1595,2743,132,19,5,4494
33015,"New Hampshire","South Hampton",246,315,19,3,2,585
33015,"New Hampshire","Stratham",2593,2005,218,36,5,4857
33015,"New Hampshire","Windham",3507,4825,372,46,10,8760
33017,"New Hampshire","Barrington",2375,2469,309,65,4,5222
33017,"New Hampshire","Dover Ward 1",1863,733,139,49,5,2789
33017,"New Hampshire","Dover Ward 2",1903,856,144,43,1,2947
33017,"New Hampshire","Dover Ward 3",1960,1298,139,29,6,3432
33017,"New Hampshire","Dover Ward 4",1763,1152,153,22,2,3092
33017,"New Hampshire","Dover Ward 5",1381,951,139,29,2,2502
33017,"New Hampshire","Dover Ward 6",1248,1025,100,11,5,2389
33017,"New Hampshire","Durham",6501,2450,455,119,5,9530
33017,"New Hampshire","Farmington",1127,1785,154,30,4,3100
33017,"New Hampshire","Lee",1630,824,124,33,5,2616
33017,"New Hampshire","Madbury",632,422,67,10,0,1131
33017,"New Hampshire","Middleton",289,602,24,5,2,922
33017,"New Hampshire","Milton",847,1339,94,20,1,2301
33017,"New Hampshire","New Durham",578,981,69,13,2,1643
33017,"New Hampshire","Rochester Ward 1",1071,1407,134,21,2,2635
33017,"New Hampshire","Rochester Ward 2",1150,1425,147,15,1,2738
33017,"New Hampshire","Rochester Ward 3",1017,1370,131,27,1,2546
33017,"New Hampshire","Rochester Ward 4",1048,1190,103,25,5,2371
33017,"New Hampshire","Rochester Ward 5",1034,1388,117,13,2,2554
33017,"New Hampshire","Rochester Ward 6",947,1009,110,25,0,2091
33017,"New Hampshire","Rollinsford",769,711,83,18,1,1582
33017,"New Hampshire","Somersworth Ward 1",683,624,67,11,3,1388
33017,"New Hampshire","Somersworth Ward 2",523,488,34,16,0,1061
33017,"New Hampshire","Somersworth Ward 3",500,513,45,7,0,1065
33017,"New Hampshire","Somersworth Ward 4",533,437,38,10,1,1019
33017,"New Hampshire","Somersworth Ward 5",404,327,32,15,1,779
33017,"New Hampshire","Strafford",1118,1296,107,13,1,2535
33019,"New Hampshire","Acworth",274,240,10,17,11,552
33019,"New Hampshire","Charlestown",1041,1159,92,20,5,2317
33019,"New Hampshire","Claremont Ward 1",716,715,81,23,2,1537
33019,"New Hampshire","Claremont Ward 2",974,1039,91,28,0,2132
33019,"New Hampshire","Claremont Ward 3",839,926,64,14,0,1843
33019,"New Hampshire","Cornish",570,400,35,7,0,1012
33019,"New Hampshire","Croydon",126,271,19,4,0,420
33019,"New Hampshire","Goshen",153,260,16,8,1,438
33019,"New Hampshire","Grantham",1265,699,54,16,2,2036
33019,"New Hampshire","Langdon",184,197,8,1,0,390
33019,"New Hampshire","Lempster",226,428,16,10,0,680
33019,"New Hampshire","Newport",1085,1665,125,25,4,2904
33019,"New Hampshire","Plainfield",957,458,61,12,0,1488
33019,"New Hampshire","Springfield",344,422,44,7,0,817
33019,"New Hampshire","Sunapee",928,1044,83,23,2,2080
33019,"New Hampshire","Unity",281,473,29,13,1,797
33019,"New Hampshire","Washington",247,400,29,10,0,686
34001,"New Jersey","ATLANTIC",60924,52690,2109,999,569,117291
34003,"New Jersey","BERGEN",231211,175529,7764,3988,804,419296
34005,"New Jersey","BURLINGTON",121725,89272,4946,2349,651,218943
34007,"New Jersey","CAMDEN",146717,72631,4245,2003,996,226592
34009,"New Jersey","CAPE MAY",18750,28446,903,390,233,48722
34011,"New Jersey","CUMBERLAND",27771,24453,1043,489,248,54004
34013,"New Jersey","ESSEX",240837,63176,3111,2921,889,310934
34015,"New Jersey","GLOUCESTER",66870,67544,3216,1256,656,139542
34017,"New Jersey","HUDSON",163917,49043,2922,2657,836,219375
34019,"New Jersey","HUNTERDON",28898,38712,2213,805,208,70836
34021,"New Jersey","MERCER",104775,46193,3267,1677,617,156529
34023,"New Jersey","MIDDLESEX",193044,122953,5446,3452,1207,326102
34025,"New Jersey","MONMOUTH",137181,166723,6388,3189,896,314377
34027,"New Jersey","MORRIS",115249,126071,5943,2532,621,250416
34029,"New Jersey","OCEAN",87150,179079,4867,2122,1144,274362
34031,"New Jersey","PASSAIC",116759,72902,2541,1948,652,194802
34033,"New Jersey","SALEM",11904,16381,862,238,109,29494
34035,"New Jersey","SOMERSET",85689,65505,3776,1568,554,157092
34037,"New Jersey","SUSSEX",24212,46658,2026,845,385,74126
34039,"New Jersey","UNION",147414,68114,3628,1779,1040,221975
34041,"New Jersey","WARREN",17281,29858,1261,565,271,49236
35001,"New Mexico","Bernalillo",143417,94698,29682,3614,3251,274662
35003,"New Mexico","Catron",427,1464,111,23,24,2049
35005,"New Mexico","Chaves",5534,12872,1609,86,170,20271
35006,"New Mexico","Cibola",3741,3195,970,73,84,8063
35007,"New Mexico","Colfax",2129,2585,527,37,54,5332
35009,"New Mexico","Curry",3121,9035,973,74,167,13370
35011,"New Mexico","De Baca",193,620,89,6,2,910
35013,"New Mexico","Dona Ana",37947,25374,5471,953,903,70648
35015,"New Mexico","Eddy",5033,13147,1275,84,128,19667
35017,"New Mexico","Grant",6276,5288,899,218,130,12811
35019,"New Mexico","Guadalupe",970,595,238,18,6,1827
35021,"New Mexico","Harding",156,311,55,3,2,527
35023,"New Mexico","Hidalgo",784,910,137,6,35,1872
35025,"New Mexico","Lea",3930,12495,1098,56,133,17712
35027,"New Mexico","Lincoln",2331,5896,560,59,56,8902
35028,"New Mexico","Los Alamos",5562,3359,1512,120,332,10885
35029,"New Mexico","Luna",3195,3478,481,66,75,7295
35031,"New Mexico","McKinley",13576,5104,2412,284,327,21703
35033,"New Mexico","Mora",1536,665,194,35,11,2441
35035,"New Mexico","Otero",6124,11886,1613,169,267,20059
35037,"New Mexico","Quay",1017,2212,299,15,29,3572
35039,"New Mexico","Rio Arriba",9592,3599,1425,188,74,14878
35041,"New Mexico","Roosevelt",1454,3884,482,48,82,5950
35043,"New Mexico","Sandoval",27707,25905,6657,627,794,61690
35045,"New Mexico","San Juan",12865,27946,4200,352,747,46110
35047,"New Mexico","San Miguel",7285,2313,915,160,78,10751
35049,"New Mexico","Santa Fe",50793,14332,4362,1452,495,71434
35051,"New Mexico","Sierra",1612,3010,442,78,39,5181
35053,"New Mexico","Socorro",3313,2616,802,60,77,6868
35055,"New Mexico","Taos",10668,2727,1179,617,69,15260
35057,"New Mexico","Torrance",1785,3714,692,66,67,6324
35059,"New Mexico","Union",320,1216,134,13,19,1702
35061,"New Mexico","Valencia",10841,13215,3046,219,271,27592
36001,"New York","Albany",83080,47810,4792,2474,3257,141413
36003,"New York","Allegany",4882,12525,735,275,455,18872
36005,"New York","Bronx",353646,37797,2312,4341,4881,402977
36007,"New York","Broome",39212,40943,3246,1546,2230,87177
36009,"New York","Cattaraugus",9497,19692,1246,440,678,31553
36011,"New York","Cayuga",13522,17384,1358,501,682,33447
36013,"New York","Chautauqua",19091,31594,2203,757,1165,54810
36015,"New York","Chemung",13757,20097,1447,463,750,36514
36017,"New York","Chenango",6775,11921,916,358,349,20319
36019,"New York","Clinton",15059,14449,1312,613,3103,34536
36021,"New York","Columbia",15284,13756,944,598,570,31152
36023,"New York","Cortland",8771,9900,957,374,451,20453
36025,"New York","Delaware",6627,11942,650,377,336,19932
36027,"New York","Dutchess",62261,61797,3600,1986,2590,132234
36029,"New York","Erie",215460,188303,12720,6367,8687,431537
36031,"New York","Essex",7764,7958,728,420,592,17462
36033,"New York","Franklin",7297,8221,717,359,595,17189
36035,"New York","Fulton",6496,13462,779,311,416,21464
36037,"New York","Genesee",7650,16915,1319,324,468,26676
36039,"New York","Greene",7405,13073,647,442,758,22325
36041,"New York","Hamilton",949,2064,119,44,101,3277
36043,"New York","Herkimer",8083,16699,1002,403,510,26697
36045,"New York","Jefferson",13809,21763,1670,617,754,38613
36047,"New York","Kings",640566,141044,6864,11932,10099,810505
36049,"New York","Lewis",3146,7400,496,132,281,11455
36051,"New York","Livingston",10698,17290,1276,449,600,30313
36053,"New York","Madison",11667,15936,1582,516,652,30353
36055,"New York","Monroe",188594,136582,13205,5289,7298,350968
36057,"New York","Montgomery",6595,11301,690,268,420,19274
36059,"New York","Nassau",326094,288313,11146,6648,10347,642548
36061,"New York","New York",579019,64929,9408,9441,10314,673111
36063,"New York","Niagara",35559,51961,2865,1287,2621,94293
36065,"New York","Oneida",33743,51437,3754,1235,1743,91912
36067,"New York","Onondaga",112337,83649,8524,3185,5169,212864
36069,"New York","Ontario",22233,26029,2486,852,1091,52691
36071,"New York","Orange",68281,76645,3867,2154,5719,156666
36073,"New York","Orleans",4470,10936,680,184,299,16569
36075,"New York","Oswego",17096,27688,2137,705,921,48547
36077,"New York","Otsego",10451,13308,1066,520,592,25937
36079,"New York","Putnam",19368,27024,1171,590,712,48865
36081,"New York","Queens",517229,149341,7116,9230,8293,691209
36083,"New York","Rensselaer",32722,33726,2944,1355,1388,72135
36085,"New York","Richmond",74146,101437,2432,1886,2219,182120
36087,"New York","Rockland",69343,60911,2284,1348,4163,138049
36089,"New York","St. Lawrence",16488,19942,1445,807,950,39632
36091,"New York","Saratoga",50913,54575,5116,1825,2689,115118
36093,"New York","Schenectady",33752,28953,2624,1127,1449,67905
36095,"New York","Schoharie",4240,8831,531,274,289,14165
36097,"New York","Schuyler",3091,5050,309,216,167,8833
36099,"New York","Seneca",5697,7236,638,259,260,14090
36101,"New York","Steuben",12526,26831,1666,585,726,42334
36103,"New York","Suffolk",303614,350327,13909,8093,10530,686473
36105,"New York","Sullivan",12568,15931,734,504,747,30484
36107,"New York","Tioga",7526,13260,930,337,502,22555
36109,"New York","Tompkins",28890,10371,1393,1380,1005,43039
36111,"New York","Ulster",42107,34006,2281,2061,2493,82948
36113,"New York","Warren",13091,15751,1255,863,756,31716
36115,"New York","Washington",9098,13610,926,578,561,24773
36117,"New York","Wayne",13473,23380,1911,567,678,40009
36119,"New York","Westchester",272932,131238,8042,4358,7485,424055
36121,"New York","Wyoming",3904,12442,673,180,302,17501
36123,"New York","Yates",3659,5660,494,146,262,10221
37001,"North Carolina","ALAMANCE",29818,38802,1795,216,496,71127
37003,"North Carolina","ALEXANDER",3767,13892,437,23,151,18270
37005,"North Carolina","ALLEGHANY",1306,3814,129,0,66,5315
37007,"North Carolina","ANSON",5859,4506,129,3,48,10545
37009,"North Carolina","ASHE",3500,9413,332,0,180,13425
37011,"North Carolina","AVERY",1689,6298,166,23,73,8249
37013,"North Carolina","BEAUFORT",8764,14543,426,25,180,23938
37015,"North Carolina","BERTIE",5778,3456,70,3,40,9347
37017,"North Carolina","BLADEN",7021,8511,211,0,76,15819
37019,"North Carolina","BRUNSWICK",23282,42717,1717,96,536,68348
37021,"North Carolina","BUNCOMBE",75421,55694,4284,1534,1958,138891
37023,"North Carolina","BURKE",11251,26238,988,119,324,38920
37025,"North Carolina","CABARRUS",35510,53789,2784,190,972,93245
37027,"North Carolina","CALDWELL",8425,26621,849,123,302,36320
37029,"North Carolina","CAMDEN",1274,3546,149,8,29,5006
37031,"North Carolina","CARTERET",9939,26569,913,82,278,37781
37033,"North Carolina","CASWELL",4792,6027,214,9,29,11071
37035,"North Carolina","CATAWBA",21216,48324,1973,153,685,72351
37037,"North Carolina","CHATHAM",21065,17105,1130,137,412,39849
37039,"North Carolina","CHEROKEE",2860,10844,346,33,98,14181
37041,"North Carolina","CHOWAN",2992,4014,162,11,49,7228
37043,"North Carolina","CLAY",1367,4437,143,9,54,6010
37045,"North Carolina","CLEVELAND",14964,28479,850,75,305,44673
37047,"North Carolina","COLUMBUS",9053,14264,305,0,91,23713
37049,"North Carolina","CRAVEN",17629,27722,1210,50,380,46991
37051,"North Carolina","CUMBERLAND",71605,51265,3373,179,1084,127506
37053,"North Carolina","CURRITUCK",2913,9163,482,27,84,12669
37055,"North Carolina","DARE",7323,11626,690,52,205,19896
37057,"North Carolina","DAVIDSON",18102,54304,1858,87,484,74835
37059,"North Carolina","DAVIE",5270,15602,631,47,206,21756
37061,"North Carolina","DUPLIN",8283,12217,260,11,85,20856
37063,"North Carolina","DURHAM",121166,28314,3995,535,1996,156006
37065,"North Carolina","EDGECOMBE",16224,8261,284,11,106,24886
37067,"North Carolina","FORSYTH",94442,75947,5367,0,2499,178255
37069,"North Carolina","FRANKLIN",12874,16368,777,53,296,30368
37071,"North Carolina","GASTON",31177,61798,2445,138,873,96431
37073,"North Carolina","GATES",2385,2874,108,0,25,5392
37075,"North Carolina","GRAHAM",768,3281,74,0,43,4166
37077,"North Carolina","GRANVILLE",12909,13591,596,42,215,27353
37079,"North Carolina","GREENE",3605,4374,85,4,27,8095
37081,"North Carolina","GUILFORD",149248,98062,6754,674,2667,257405
37083,"North Carolina","HALIFAX",15748,9031,290,0,98,25167
37085,"North Carolina","HARNETT",16737,27614,1252,73,389,46065
37087,"North Carolina","HAYWOOD",10473,18929,905,117,303,30727
37089,"North Carolina","HENDERSON",19827,35807,1626,227,687,58174
37091,"North Carolina","HERTFORD",6910,3099,133,0,44,10186
37093,"North Carolina","HOKE",9725,7759,577,27,140,18228
37095,"North Carolina","HYDE",965,1288,42,1,8,2304
37097,"North Carolina","IREDELL",24734,54754,2185,140,754,82567
37099,"North Carolina","JACKSON",7713,9870,742,112,276,18713
37101,"North Carolina","JOHNSTON",28362,54372,2347,112,716,85909
37103,"North Carolina","JONES",2065,2974,59,0,37,5135
37105,"North Carolina","LEE",10469,13712,684,28,191,25084
37107,"North Carolina","LENOIR",12726,13667,401,19,146,26959
37109,"North Carolina","LINCOLN",9897,28806,971,44,305,40023
37111,"North Carolina","MCDOWELL",4667,14568,396,15,229,19875
37113,"North Carolina","MACON",4876,12127,467,36,228,17734
37115,"North Carolina","MADISON",3926,6783,336,121,103,11269
37117,"North Carolina","MARTIN",5846,5897,165,9,47,11964
37119,"North Carolina","MECKLENBURG",294562,155518,15488,1352,5937,472857
37121,"North Carolina","MITCHELL",1596,6282,138,24,56,8096
37123,"North Carolina","MONTGOMERY",4150,7130,203,6,51,11540
37125,"North Carolina","MOORE",16328,30487,1354,54,464,48687
37127,"North Carolina","NASH",23235,23318,750,60,301,47664
37129,"North Carolina","NEW HANOVER",50975,55340,3949,449,1184,111897
37131,"North Carolina","NORTHAMPTON",6144,3582,93,0,29,9848
37133,"North Carolina","ONSLOW",17514,37122,1926,92,481,57135
37135,"North Carolina","ORANGE",59923,18557,2404,459,997,82340
37137,"North Carolina","PAMLICO",2448,4258,124,10,30,6870
37139,"North Carolina","PASQUOTANK",8615,8180,442,32,122,17391
37141,"North Carolina","PENDER",9354,17639,683,52,157,27885
37143,"North Carolina","PERQUIMANS",2319,4177,162,7,43,6708
37145,"North Carolina","PERSON",7833,11185,419,36,142,19615
37147,"North Carolina","PITT",41824,35691,2162,170,680,80527
37149,"North Carolina","POLK",3735,6768,272,52,107,10934
37151,"North Carolina","RANDOLPH",13194,49430,1403,102,446,64575
37153,"North Carolina","RICHMOND",8501,10383,333,24,87,19328
37155,"North Carolina","ROBESON",19016,20762,803,25,252,40858
37157,"North Carolina","ROCKINGHAM",14228,26830,871,55,294,42278
37159,"North Carolina","ROWAN",19400,42810,1517,78,564,64369
37161,"North Carolina","RUTHERFORD",7515,21869,624,39,261,30308
37163,"North Carolina","SAMPSON",10547,14838,393,0,150,25928
37165,"North Carolina","SCOTLAND",7319,6256,254,26,73,13928
37167,"North Carolina","STANLY",7094,21964,664,26,169,29917
37169,"North Carolina","STOKES",4665,17116,571,25,173,22550
37171,"North Carolina","SURRY",7488,23671,739,48,250,32196
37173,"North Carolina","SWAIN",2196,3566,240,29,92,6123
37175,"North Carolina","TRANSYLVANIA",6558,10520,489,82,220,17869
37177,"North Carolina","TYRRELL",720,975,28,5,11,1739
37179,"North Carolina","UNION",34335,66705,3327,163,1176,105706
37181,"North Carolina","VANCE",12229,7332,294,25,97,19977
37183,"North Carolina","WAKE",302727,196080,19460,1740,7605,527612
37185,"North Carolina","WARREN",6419,3215,147,0,69,9850
37187,"North Carolina","WASHINGTON",3509,2564,65,1,25,6164
37189,"North Carolina","WATAUGA",14138,13697,1336,275,539,29985
37191,"North Carolina","WAYNE",21769,27540,963,33,383,50688
37193,"North Carolina","WILKES",6638,23752,647,31,228,31296
37195,"North Carolina","WILSON",19663,17531,667,18,256,38135
37197,"North Carolina","YADKIN",3160,13880,398,34,152,17624
37199,"North Carolina","YANCEY",3196,6385,261,41,77,9960
38001,"North Dakota","Adams",216,909,65,8,20,1218
38003,"North Dakota","Barnes",1597,3160,407,47,133,5344
38005,"North Dakota","Benson",842,929,112,41,87,2011
38007,"North Dakota","Billings",59,495,33,4,14,605
38009,"North Dakota","Bottineau",736,2494,177,30,57,3494
38011,"North Dakota","Bowman",227,1446,79,13,22,1787
38013,"North Dakota","Burke",119,895,26,5,7,1052
38015,"North Dakota","Burleigh",10881,32532,2722,480,1364,47979
38017,"North Dakota","Cass",31361,39816,6085,1209,2350,80821
38019,"North Dakota","Cavalier",476,1357,110,19,44,2006
38021,"North Dakota","Dickey",554,1667,123,23,40,2407
38023,"North Dakota","Divide",245,867,71,9,27,1219
38025,"North Dakota","Dunn",358,1771,60,14,40,2243
38027,"North Dakota","Eddy",355,791,53,15,17,1231
38029,"North Dakota","Emmons",215,1677,52,10,27,1981
38031,"North Dakota","Foster",347,1241,96,10,25,1719
38033,"North Dakota","Golden Valley",99,796,40,4,18,957
38035,"North Dakota","Grand Forks",10851,16340,2004,383,787,30365
38037,"North Dakota","Grant",185,1108,65,7,16,1381
38039,"North Dakota","Griggs",298,847,93,6,21,1265
38041,"North Dakota","Hettinger",168,1050,46,5,27,1296
38043,"North Dakota","Kidder",179,1111,64,7,15,1376
38045,"North Dakota","LaMoure",502,1481,109,13,46,2151
38047,"North Dakota","Logan",114,888,38,5,22,1067
38049,"North Dakota","McHenry",490,2050,189,20,71,2820
38051,"North Dakota","McIntosh",235,1100,71,10,30,1446
38053,"North Dakota","McKenzie",698,3670,172,35,97,4672
38055,"North Dakota","McLean",1081,3860,256,29,89,5315
38057,"North Dakota","Mercer",621,3759,190,21,91,4682
38059,"North Dakota","Morton",3080,11336,914,141,361,15832
38061,"North Dakota","Mountrail",1220,2582,166,56,82,4106
38063,"North Dakota","Nelson",536,1025,114,11,31,1717
38065,"North Dakota","Oliver",119,830,47,3,18,1017
38067,"North Dakota","Pembina",681,2208,167,28,69,3153
38069,"North Dakota","Pierce",431,1437,132,9,62,2071
38071,"North Dakota","Ramsey",1505,3217,405,44,134,5305
38073,"North Dakota","Ransom",838,1210,247,22,42,2359
38075,"North Dakota","Renville",201,993,71,4,24,1293
38077,"North Dakota","Richland",2064,4767,493,76,192,7592
38079,"North Dakota","Rolette",2099,1217,156,175,108,3755
38081,"North Dakota","Sargent",694,1088,167,18,30,1997
38083,"North Dakota","Sheridan",95,650,29,1,12,787
38085,"North Dakota","Sioux",758,260,25,128,61,1232
38087,"North Dakota","Slope",43,362,19,3,3,430
38089,"North Dakota","Stark",1753,9755,526,60,228,12322
38091,"North Dakota","Steele",361,538,75,6,19,999
38093,"North Dakota","Stutsman",2498,6718,574,109,256,10155
38095,"North Dakota","Towner",305,733,90,7,22,1157
38097,"North Dakota","Traill",1241,2265,292,35,100,3933
38099,"North Dakota","Walsh",1167,2995,330,32,112,4636
38101,"North Dakota","Ward",5806,18636,2055,242,673,27412
38103,"North Dakota","Wells",419,1796,101,14,53,2383
38105,"North Dakota","Williams",1735,10069,631,74,298,12807
39001,"Ohio","Adams",2326,8659,226,47,101,11359
39003,"Ohio","Allen",13294,30487,1486,323,304,45894
39005,"Ohio","Ashland",5740,17493,906,185,266,24590
39007,"Ohio","Ashtabula",15577,23318,1213,427,332,40867
39009,"Ohio","Athens",16370,11354,1012,539,168,29443
39011,"Ohio","Auglaize",3980,18658,701,112,176,23627
39013,"Ohio","Belmont",8785,21108,777,195,257,31122
39015,"Ohio","Brown",4353,14573,431,103,147,19607
39017,"Ohio","Butler",58642,106976,5790,1173,1258,173839
39019,"Ohio","Carroll",3154,9254,450,91,125,13074
39021,"Ohio","Champaign",4594,12631,582,147,150,18104
39023,"Ohio","Clark",23328,35205,1895,511,490,61429
39025,"Ohio","Clermont",26715,67518,3504,728,656,99121
39027,"Ohio","Clinton",4066,13838,514,127,130,18675
39029,"Ohio","Columbiana",12432,31676,1401,320,372,46201
39031,"Ohio","Coshocton",4013,10785,468,118,168,15552
39033,"Ohio","Crawford",4625,13611,714,119,168,19237
39035,"Ohio","Cuyahoga",398271,184211,12993,5242,3105,603822
39037,"Ohio","Darke",4470,20012,649,149,204,25484
39039,"Ohio","Defiance",5368,11688,782,153,201,18192
39041,"Ohio","Delaware",40872,57568,4116,668,636,103860
39043,"Ohio","Erie",16057,19648,1225,342,306,37578
39045,"Ohio","Fairfield",24881,44314,2439,558,721,72913
39047,"Ohio","Fayette",2739,7995,295,57,76,11162
39049,"Ohio","Franklin",351198,199331,19725,6106,4780,581140
39051,"Ohio","Fulton",6069,13709,1024,167,256,21225
39053,"Ohio","Gallia",2628,9822,285,98,98,12931
39055,"Ohio","Geauga",17569,30227,1502,333,310,49941
39057,"Ohio","Greene",28943,48540,3277,680,418,81858
39059,"Ohio","Guernsey",4359,11445,549,99,105,16557
39061,"Ohio","Hamilton",215719,173665,13200,3723,2802,409109
39063,"Ohio","Hancock",9609,24183,1535,319,377,36023
39065,"Ohio","Hardin",2920,8717,465,80,112,12294
39067,"Ohio","Harrison",1688,5098,178,53,62,7079
39069,"Ohio","Henry",3756,9301,659,111,105,13932
39071,"Ohio","Highland",3773,14020,473,103,132,18501
39073,"Ohio","Hocking",3775,8497,367,90,109,12838
39075,"Ohio","Holmes",1788,8720,374,53,119,11054
39077,"Ohio","Huron",7192,16226,923,192,301,24834
39079,"Ohio","Jackson",3226,9949,373,64,81,13693
39081,"Ohio","Jefferson",9675,21117,841,194,374,32201
39083,"Ohio","Knox",8171,19131,936,208,241,28687
39085,"Ohio","Lake",46397,64255,3833,946,815,116246
39087,"Ohio","Lawrence",6974,18689,589,160,195,26607
39089,"Ohio","Licking",27376,51241,2708,725,711,82761
39091,"Ohio","Logan",4647,15957,657,129,181,21571
39093,"Ohio","Lorain",66949,66818,4548,1255,992,140562
39095,"Ohio","Lucas",110833,75698,7410,2252,1363,197556
39097,"Ohio","Madison",4779,11631,600,110,170,17290
39099,"Ohio","Mahoning",57381,53616,2606,874,595,115072
39101,"Ohio","Marion",7928,16961,986,238,209,26322
39103,"Ohio","Medina",32182,54810,2975,709,697,91373
39105,"Ohio","Meigs",2260,7309,280,66,70,9985
39107,"Ohio","Mercer",3384,17506,562,110,164,21726
39109,"Ohio","Miami",13120,37079,1837,315,383,52734
39111,"Ohio","Monroe",1662,4868,162,36,67,6795
39113,"Ohio","Montgomery",122016,123909,8387,2282,1707,258301
39115,"Ohio","Morgan",1736,4431,192,45,39,6443
39117,"Ohio","Morrow",3761,11948,569,102,168,16548
39119,"Ohio","Muskingum",11123,24056,1244,261,307,36991
39121,"Ohio","Noble",1221,4549,152,34,57,6013
39123,"Ohio","Ottawa",8285,12653,957,147,176,22218
39125,"Ohio","Paulding",2093,6500,279,78,97,9047
39127,"Ohio","Perry",4138,10228,405,103,121,14995
39129,"Ohio","Pickaway",6529,17076,756,180,204,24745
39131,"Ohio","Pike",3539,7902,283,58,97,11879
39133,"Ohio","Portage",32397,39971,2415,840,516,76139
39135,"Ohio","Preble",4325,15446,553,126,115,20565
39137,"Ohio","Putnam",2922,14961,638,72,174,18767
39139,"Ohio","Richland",16085,36590,1637,387,515,55214
39141,"Ohio","Ross",10356,18652,934,209,229,30380
39143,"Ohio","Sandusky",9929,16316,1263,311,225,28044
39145,"Ohio","Scioto",9132,20550,699,217,186,30784
39147,"Ohio","Seneca",7404,14825,1302,242,214,23987
39149,"Ohio","Shelby",4243,18590,594,125,188,23740
39151,"Ohio","Stark",68146,98388,5693,1393,1619,175239
39153,"Ohio","Summit",134256,112026,7472,2330,1895,257979
39155,"Ohio","Trumbull",43014,49024,2489,849,653,96029
39157,"Ohio","Tuscarawas",12188,26918,1606,287,290,41289
39159,"Ohio","Union",7718,18096,1119,207,289,27429
39161,"Ohio","Van Wert",2697,10469,429,105,70,13770
39163,"Ohio","Vinton",1351,3883,168,43,57,5502
39165,"Ohio","Warren",33730,77643,4335,715,844,117267
39167,"Ohio","Washington",8026,20514,892,208,200,29840
39169,"Ohio","Wayne",15031,32270,1624,379,549,49853
39171,"Ohio","Williams",4358,11939,703,130,178,17308
39173,"Ohio","Wood",27318,32498,3264,689,572,64341
39175,"Ohio","Wyandot",2515,7468,437,85,87,10592
40001,"Oklahoma","ADAIR",1382,4787,344,NA,NA,6513
40003,"Oklahoma","ALFALFA",216,1933,109,NA,NA,2258
40005,"Oklahoma","ATOKA",795,4084,139,NA,NA,5018
40007,"Oklahoma","BEAVER",176,1993,74,NA,NA,2243
40009,"Oklahoma","BECKHAM",960,6308,284,NA,NA,7552
40011,"Oklahoma","BLAINE",711,2884,198,NA,NA,3793
40013,"Oklahoma","BRYAN",2804,10478,536,NA,NA,13818
40015,"Oklahoma","CADDO",2420,6482,446,NA,NA,9348
40017,"Oklahoma","CANADIAN",11674,39986,3618,NA,NA,55278
40019,"Oklahoma","CARTER",4002,13752,780,NA,NA,18534
40021,"Oklahoma","CHEROKEE",5456,9994,1040,NA,NA,16490
40023,"Oklahoma","CHOCTAW",1067,4206,153,NA,NA,5426
40025,"Oklahoma","CIMARRON",71,963,45,NA,NA,1079
40027,"Oklahoma","CLEVELAND",38829,62538,8083,NA,NA,109450
40029,"Oklahoma","COAL",411,1898,90,NA,NA,2399
40031,"Oklahoma","COMANCHE",11463,19183,1918,NA,NA,32564
40033,"Oklahoma","COTTON",424,2054,124,NA,NA,2602
40035,"Oklahoma","CRAIG",1252,4283,250,NA,NA,5785
40037,"Oklahoma","CREEK",5841,21575,1414,NA,NA,28830
40039,"Oklahoma","CUSTER",2104,7826,611,NA,NA,10541
40041,"Oklahoma","DELAWARE",3311,11826,579,NA,NA,15716
40043,"Oklahoma","DEWEY",222,1965,61,NA,NA,2248
40045,"Oklahoma","ELLIS",155,1611,61,NA,NA,1827
40047,"Oklahoma","GARFIELD",4397,16009,1304,NA,NA,21710
40049,"Oklahoma","GARVIN",1855,8253,438,NA,NA,10546
40051,"Oklahoma","GRADY",3882,17316,1088,NA,NA,22286
40053,"Oklahoma","GRANT",288,1827,86,NA,NA,2201
40055,"Oklahoma","GREER",323,1482,91,NA,NA,1896
40057,"Oklahoma","HARMON",225,715,37,NA,NA,977
40059,"Oklahoma","HARPER",134,1318,47,NA,NA,1499
40061,"Oklahoma","HASKELL",882,3701,155,NA,NA,4738
40063,"Oklahoma","HUGHES",961,3388,177,NA,NA,4526
40065,"Oklahoma","JACKSON",1473,5969,364,NA,NA,7806
40067,"Oklahoma","JEFFERSON",365,1910,75,NA,NA,2350
40069,"Oklahoma","JOHNSTON",786,3093,139,NA,NA,4018
40071,"Oklahoma","KAY",3738,12172,893,NA,NA,16803
40073,"Oklahoma","KINGFISHER",786,5156,189,NA,NA,6131
40075,"Oklahoma","KIOWA",767,2596,130,NA,NA,3493
40077,"Oklahoma","LATIMER",797,3100,159,NA,NA,4056
40079,"Oklahoma","LEFLORE",3250,13362,609,NA,NA,17221
40081,"Oklahoma","LINCOLN",2430,10854,741,NA,NA,14025
40083,"Oklahoma","LOGAN",4248,13633,1098,NA,NA,18979
40085,"Oklahoma","LOVE",735,2922,132,NA,NA,3789
40087,"Oklahoma","MCCLAIN",2894,13169,795,NA,NA,16858
40089,"Oklahoma","MCCURTAIN",1802,8656,268,NA,NA,10726
40091,"Oklahoma","MCINTOSH",2123,5505,335,NA,NA,7963
40093,"Oklahoma","MAJOR",310,2948,149,NA,NA,3407
40095,"Oklahoma","MARSHALL",1096,4206,190,NA,NA,5492
40097,"Oklahoma","MAYES",3423,11555,739,NA,NA,15717
40099,"Oklahoma","MURRAY",1087,4175,266,NA,NA,5528
40101,"Oklahoma","MUSKOGEE",7977,15043,1196,NA,NA,24216
40103,"Oklahoma","NOBLE",901,3715,262,NA,NA,4878
40105,"Oklahoma","NOWATA",742,3321,174,NA,NA,4237
40107,"Oklahoma","OKFUSKEE",943,2800,200,NA,NA,3943
40109,"Oklahoma","OKLAHOMA",112813,141569,19560,NA,NA,273942
40111,"Oklahoma","OKMULGEE",4385,8944,620,NA,NA,13949
40113,"Oklahoma","OSAGE",5597,12577,792,NA,NA,18966
40115,"Oklahoma","OTTAWA",2584,7631,475,NA,NA,10690
40117,"Oklahoma","PAWNEE",1344,4729,291,NA,NA,6364
40119,"Oklahoma","PAYNE",8788,16651,2321,NA,NA,27760
40121,"Oklahoma","PITTSBURG",3711,12753,807,NA,NA,17271
40123,"Oklahoma","PONTOTOC",3637,10431,763,NA,NA,14831
40125,"Oklahoma","POTTAWATOMIE",6015,17848,1589,NA,NA,25452
40127,"Oklahoma","PUSHMATAHA",748,3581,154,NA,NA,4483
40129,"Oklahoma","ROGER MILLS",151,1547,61,NA,NA,1759
40131,"Oklahoma","ROGERS",7902,30913,2047,NA,NA,40862
40133,"Oklahoma","SEMINOLE",2071,5613,353,NA,NA,8037
40135,"Oklahoma","SEQUOYAH",3061,10888,488,NA,NA,14437
40137,"Oklahoma","STEPHENS",3086,14182,636,NA,NA,17904
40139,"Oklahoma","TEXAS",858,4621,301,NA,NA,5780
40141,"Oklahoma","TILLMAN",657,1944,105,NA,NA,2706
40143,"Oklahoma","TULSA",87847,144258,14949,NA,NA,247054
40145,"Oklahoma","WAGONER",6723,23005,1572,NA,NA,31300
40147,"Oklahoma","WASHINGTON",5048,15825,1351,NA,NA,22224
40149,"Oklahoma","WASHITA",588,3854,189,NA,NA,4631
40151,"Oklahoma","WOODS",522,2947,199,NA,NA,3668
40153,"Oklahoma","WOODWARD",873,6347,375,NA,NA,7595
41001,"Oregon","Baker",1797,6218,413,134,217,8779
41003,"Oregon","Benton",29193,13445,2692,1595,1828,48753
41005,"Oregon","Clackamas",102095,88392,11053,4001,8498,214039
41007,"Oregon","Clatsop",9252,8138,973,569,732,19664
41009,"Oregon","Columbia",10167,13217,1646,572,1016,26618
41011,"Oregon","Coos",10448,17865,1411,755,834,31313
41013,"Oregon","Crook",2637,8511,518,157,349,12172
41015,"Oregon","Curry",4300,7212,498,273,328,12611
41017,"Oregon","Deschutes",42444,45692,5158,1998,3265,98557
41019,"Oregon","Douglas",14096,34582,2413,1021,1409,53521
41021,"Oregon","Gilliam",239,671,79,7,23,1019
41023,"Oregon","Grant",739,3210,209,48,134,4340
41025,"Oregon","Harney",683,2912,222,42,115,3974
41027,"Oregon","Hood River",6510,3272,511,300,317,10910
41029,"Oregon","Jackson",44447,53870,4373,2996,3641,109327
41031,"Oregon","Jefferson",2980,5483,493,182,321,9459
41033,"Oregon","Josephine",13453,26923,1829,1057,1298,44560
41035,"Oregon","Klamath",7210,20435,1525,508,829,30507
41037,"Oregon","Lake",639,3022,151,42,76,3930
41039,"Oregon","Lane",102753,67141,8476,6302,7278,191950
41041,"Oregon","Lincoln",12501,10039,1130,748,838,25256
41043,"Oregon","Linn",17995,33488,3431,1339,2466,58719
41045,"Oregon","Malheur",2246,7194,427,177,391,10435
41047,"Oregon","Marion",57788,63377,7058,2868,5749,136840
41049,"Oregon","Morrow",1017,2721,238,52,139,4167
41051,"Oregon","Multnomah",292561,67954,12862,12969,12757,399103
41053,"Oregon","Polk",16420,18940,2254,907,1774,40295
41055,"Oregon","Sherman",202,732,44,11,28,1017
41057,"Oregon","Tillamook",5768,6538,760,333,404,13803
41059,"Oregon","Umatilla",7673,17059,1457,489,919,27597
41061,"Oregon","Union",3249,8431,673,198,417,12968
41063,"Oregon","Wallowa",1116,2848,179,82,141,4366
41065,"Oregon","Wasco",4781,5833,689,239,422,11964
41067,"Oregon","Washington",153251,83197,15266,6005,11513,269232
41069,"Oregon","Wheeler",155,591,46,10,16,818
41071,"Oregon","Yamhill",19301,23250,3074,1016,2112,48753
42001,"Pennsylvania","ADAMS",14219,31423,1251,405,191,47489
42003,"Pennsylvania","ALLEGHENY",367617,259480,16102,5097,1818,650114
42005,"Pennsylvania","ARMSTRONG",7178,23484,685,141,130,31618
42007,"Pennsylvania","BEAVER",32531,48167,2022,496,355,83571
42009,"Pennsylvania","BEDFORD",3645,19552,260,102,78,23637
42011,"Pennsylvania","BERKS",78437,96626,5247,1974,781,183065
42013,"Pennsylvania","BLAIR",13958,39135,1256,338,222,54909
42015,"Pennsylvania","BRADFORD",6369,18141,893,137,168,25708
42017,"Pennsylvania","BUCKS",167060,164361,8556,3121,1199,344297
42019,"Pennsylvania","BUTLER",28584,64428,3062,615,382,97071
42021,"Pennsylvania","CAMBRIA",18867,42258,1270,413,264,63072
42023,"Pennsylvania","CAMERON",531,1589,53,6,7,2186
42025,"Pennsylvania","CARBON",8936,18743,691,265,141,28776
42027,"Pennsylvania","CENTRE",37088,35274,2644,798,344,76148
42029,"Pennsylvania","CHESTER",141682,116114,7930,2247,827,268800
42031,"Pennsylvania","CLARION",4273,12576,469,115,102,17535
42033,"Pennsylvania","CLEARFIELD",8200,24932,776,220,143,34271
42035,"Pennsylvania","CLINTON",4744,10022,470,121,37,15394
42037,"Pennsylvania","COLUMBIA",8934,18004,883,265,142,28228
42039,"Pennsylvania","CRAWFORD",10971,24987,1046,271,217,37492
42041,"Pennsylvania","CUMBERLAND",47085,69076,3975,939,542,121617
42043,"Pennsylvania","DAUPHIN",64706,60863,3498,1177,628,130872
42045,"Pennsylvania","DELAWARE",177402,110667,5992,2588,985,297634
42047,"Pennsylvania","ELK",3853,10025,401,79,68,14426
42049,"Pennsylvania","ERIE",58112,60069,3871,1139,488,123679
42051,"Pennsylvania","FAYETTE",17946,34590,853,232,146,53767
42053,"Pennsylvania","FOREST",626,1683,60,19,13,2401
42055,"Pennsylvania","FRANKLIN",17465,49768,1712,450,336,69731
42057,"Pennsylvania","FULTON",912,5694,93,37,35,6771
42059,"Pennsylvania","GREENE",4482,10849,284,83,66,15764
42061,"Pennsylvania","HUNTINGDON",4539,14494,425,96,152,19706
42063,"Pennsylvania","INDIANA",11528,24888,936,220,198,37770
42065,"Pennsylvania","JEFFERSON",3650,15192,432,110,94,19478
42067,"Pennsylvania","JUNIATA",1821,8273,201,71,88,10454
42069,"Pennsylvania","LACKAWANNA",51983,48384,1935,896,258,103456
42071,"Pennsylvania","LANCASTER",91093,137914,8555,2021,1529,241112
42073,"Pennsylvania","LAWRENCE",14009,25428,870,248,198,40753
42075,"Pennsylvania","LEBANON",18953,40525,1647,422,298,61845
42077,"Pennsylvania","LEHIGH",81324,73690,4027,1402,550,160993
42079,"Pennsylvania","LUZERNE",52451,78688,2339,1178,327,134983
42081,"Pennsylvania","LYCOMING",13020,35627,1311,384,223,50565
42083,"Pennsylvania","McKEAN",4025,11635,408,151,77,16296
42085,"Pennsylvania","MERCER",18733,31544,1370,415,247,52309
42087,"Pennsylvania","MIFFLIN",3877,14094,476,80,74,18601
42089,"Pennsylvania","MONROE",33918,33386,1502,758,188,69752
42091,"Pennsylvania","MONTGOMERY",256082,162731,10934,3704,1236,434687
42093,"Pennsylvania","MONTOUR",2857,5288,287,73,51,8556
42095,"Pennsylvania","NORTHAMPTON",66272,71736,3690,1371,450,143519
42097,"Pennsylvania","NORTHUMBERLAND",9788,25427,931,296,180,36622
42099,"Pennsylvania","PERRY",4632,15616,619,163,128,21158
42101,"Pennsylvania","PHILADELPHIA",584025,108748,7115,6679,1064,707631
42103,"Pennsylvania","PIKE",9256,16056,492,226,71,26101
42105,"Pennsylvania","POTTER",1302,6251,165,35,31,7784
42107,"Pennsylvania","SCHUYLKILL",16770,44001,1414,449,235,62869
42109,"Pennsylvania","SNYDER",4002,11725,455,111,70,16363
42111,"Pennsylvania","SOMERSET",7376,27379,678,166,174,35773
42113,"Pennsylvania","SULLIVAN",750,2291,65,14,16,3136
42115,"Pennsylvania","SUSQUEHANNA",5123,12891,568,192,89,18863
42117,"Pennsylvania","TIOGA",3901,13614,548,139,123,18325
42119,"Pennsylvania","UNION",6180,10622,450,143,73,17468
42121,"Pennsylvania","VENANGO",6309,16021,733,149,136,23348
42123,"Pennsylvania","WARREN",5145,12477,549,130,133,18434
42125,"Pennsylvania","WASHINGTON",36322,61386,2643,733,366,101450
42127,"Pennsylvania","WAYNE",7008,16244,466,206,94,24018
42129,"Pennsylvania","WESTMORELAND",59669,116522,4367,936,557,182051
42131,"Pennsylvania","WYOMING",3811,8837,323,116,57,13144
42133,"Pennsylvania","YORK",68524,128528,6484,1568,882,205986
44001,"Rhode Island","barrington",6153,2898,340,110,257,9758
44001,"Rhode Island","bristol",5771,4080,428,134,252,10665
44001,"Rhode Island","warren",2685,1987,175,73,132,5052
44003,"Rhode Island","coventry",7032,9199,669,215,399,17514
44003,"Rhode Island","east greenwich",4019,3122,283,59,206,7689
44003,"Rhode Island","warwick",20038,18338,1466,581,1017,41440
44003,"Rhode Island","west greenwich",1159,1953,150,40,72,3374
44003,"Rhode Island","west warwick",5540,5724,375,154,243,12036
44005,"Rhode Island","jamestown",2172,1148,119,46,78,3563
44005,"Rhode Island","little compton",1165,821,105,40,55,2186
44005,"Rhode Island","middletown",4248,2745,281,112,171,7557
44005,"Rhode Island","newport",6287,2644,332,144,251,9658
44005,"Rhode Island","portsmouth",4945,3922,405,128,258,9658
44005,"Rhode Island","tiverton",4034,3797,287,120,185,8423
44007,"Rhode Island","burrillville",2558,4139,295,109,169,7270
44007,"Rhode Island","central falls",3394,657,86,40,59,4236
44007,"Rhode Island","cranston",18763,15934,922,445,732,36796
44007,"Rhode Island","cumberland",8655,7444,618,180,340,17237
44007,"Rhode Island","east providence",11904,7134,631,263,478,20410
44007,"Rhode Island","foster",967,1374,99,36,58,2534
44007,"Rhode Island","glocester",1977,2914,179,90,103,5263
44007,"Rhode Island","johnston",5652,7563,315,119,195,13844
44007,"Rhode Island","lincoln",5279,5410,362,138,219,11408
44007,"Rhode Island","north providence",7760,6936,380,162,273,15511
44007,"Rhode Island","north smithfield",2570,3242,226,75,138,6251
44007,"Rhode Island","pawtucket",15574,6221,533,268,405,23001
44007,"Rhode Island","providence",45053,7682,1094,863,947,55639
44007,"Rhode Island","scituate",2045,3536,208,77,139,6005
44007,"Rhode Island","smithfield",4402,5254,377,118,227,10378
44007,"Rhode Island","woonsocket",6346,5442,447,202,254,12691
44009,"Rhode Island","charlestown",2207,1906,183,56,91,4443
44009,"Rhode Island","exeter",1471,1820,144,56,95,3586
44009,"Rhode Island","hopkinton",1766,2135,161,63,101,4226
44009,"Rhode Island","narragansett",4214,3292,275,100,196,8077
44009,"Rhode Island","new shoreham",609,214,19,16,33,891
44009,"Rhode Island","north kingstown",7793,6147,660,238,418,15256
44009,"Rhode Island","richmond",1713,2058,185,58,113,4127
44009,"Rhode Island","south kingstown",8677,4627,568,331,414,14617
44009,"Rhode Island","westerly",5291,5031,348,144,332,11146
45001,"South Carolina","Abbeville",3741,6763,129,36,106,10775
45003,"South Carolina","Aiken",25455,46025,1798,460,1113,74851
45005,"South Carolina","Allendale",2735,789,22,11,35,3592
45007,"South Carolina","Anderson",21097,56232,1592,438,1124,80483
45009,"South Carolina","Bamberg",3898,2204,51,17,44,6214
45011,"South Carolina","Barnwell",4400,4889,87,35,74,9485
45013,"South Carolina","Beaufort",32138,42922,2005,482,977,78524
45015,"South Carolina","Berkeley",30705,44587,2470,543,1212,79517
45017,"South Carolina","Calhoun",3573,3787,105,24,60,7549
45019,"South Carolina","Charleston",89299,75443,7283,1681,2639,176345
45021,"South Carolina","Cherokee",6092,15167,242,80,178,21759
45023,"South Carolina","Chester",6579,7265,175,50,123,14192
45025,"South Carolina","Chesterfield",6858,9312,185,47,179,16581
45027,"South Carolina","Clarendon",7732,7386,127,27,123,15395
45029,"South Carolina","Colleton",7627,9091,262,79,192,17251
45031,"South Carolina","Darlington",13888,14989,385,133,279,29674
45033,"South Carolina","Dillon",5834,5637,79,54,94,11698
45035,"South Carolina","Dorchester",24055,34987,2050,447,1028,62567
45037,"South Carolina","Edgefield",4491,6842,152,35,124,11644
45039,"South Carolina","Fairfield",6945,4027,120,49,126,11267
45041,"South Carolina","Florence",26710,29573,853,255,540,57931
45043,"South Carolina","Georgetown",13310,17389,498,165,295,31657
45045,"South Carolina","Greenville",74483,127832,6511,1495,4844,215165
45047,"South Carolina","Greenwood",10711,16961,580,160,351,28763
45049,"South Carolina","Hampton",5170,3488,69,19,60,8806
45051,"South Carolina","Horry",39410,89288,2276,811,1135,132920
45053,"South Carolina","Jasper",5956,5187,139,35,110,11427
45055,"South Carolina","Kershaw",10330,17542,560,143,420,28995
45057,"South Carolina","Lancaster",13812,23719,764,161,482,38938
45059,"South Carolina","Laurens",8889,16816,373,125,363,26566
45061,"South Carolina","Lee",5199,2803,63,22,69,8156
45063,"South Carolina","Lexington",35230,80026,3584,894,2359,122093
45065,"South Carolina","McCormick",2479,2652,47,8,30,5216
45067,"South Carolina","Marion",8569,5444,103,65,95,14276
45069,"South Carolina","Marlboro",5954,4267,70,33,65,10389
45071,"South Carolina","Newberry",6217,10017,313,65,195,16807
45073,"South Carolina","Oconee",7998,24178,725,225,509,33635
45075,"South Carolina","Orangeburg",26318,11931,308,125,228,38910
45077,"South Carolina","Pickens",10354,36236,1194,328,937,49049
45079,"South Carolina","Richland",108000,52469,3938,1383,2932,168722
45081,"South Carolina","Saluda",2813,5526,105,42,78,8564
45083,"South Carolina","Spartanburg",39997,76277,2443,760,1613,121090
45085,"South Carolina","Sumter",24047,18745,644,202,448,44086
45087,"South Carolina","Union",4729,7061,137,48,117,12092
45089,"South Carolina","Williamsburg",9953,4864,84,50,103,15054
45091,"South Carolina","York",41593,66754,3504,687,1819,114357
46003,"South Dakota","Aurora",340,974,74,NA,19,1407
46005,"South Dakota","Beadle",1912,4455,323,NA,82,6772
46007,"South Dakota","Bennett",412,666,57,NA,14,1149
46009,"South Dakota","Bon Homme",704,2105,129,NA,36,2974
46011,"South Dakota","Brookings",4879,6748,881,NA,172,12680
46013,"South Dakota","Brown",5452,9613,915,NA,133,16113
46015,"South Dakota","Brule",571,1565,125,NA,27,2288
46017,"South Dakota","Buffalo",296,171,18,NA,5,490
46019,"South Dakota","Butte",693,3355,246,NA,52,4346
46021,"South Dakota","Campbell",105,704,20,NA,2,831
46023,"South Dakota","Charles Mix",935,2382,98,NA,18,3433
46025,"South Dakota","Clark",398,1139,103,NA,17,1657
46027,"South Dakota","Clay",2608,2109,295,NA,57,5069
46029,"South Dakota","Codington",3174,7764,600,NA,131,11669
46031,"South Dakota","Corson",535,588,34,NA,18,1175
46033,"South Dakota","Custer",1120,3290,255,NA,51,4716
46035,"South Dakota","Davison",2355,5157,349,NA,91,7952
46037,"South Dakota","Day",974,1627,116,NA,30,2747
46039,"South Dakota","Deuel",570,1366,117,NA,27,2080
46041,"South Dakota","Dewey",887,723,71,NA,26,1707
46043,"South Dakota","Douglas",214,1338,41,NA,12,1605
46045,"South Dakota","Edmunds",380,1433,86,NA,19,1918
46047,"South Dakota","Fall River",821,2511,166,NA,65,3563
46049,"South Dakota","Faulk",204,858,45,NA,11,1118
46051,"South Dakota","Grant",970,2381,175,NA,36,3562
46053,"South Dakota","Gregory",391,1600,78,NA,22,2091
46055,"South Dakota","Haakon",77,936,27,NA,4,1044
46057,"South Dakota","Hamlin",555,2051,124,NA,32,2762
46059,"South Dakota","Hand",334,1391,76,NA,17,1818
46061,"South Dakota","Hanson",424,1497,59,NA,26,2006
46063,"South Dakota","Harding",38,694,31,NA,6,769
46065,"South Dakota","Hughes",2449,5174,480,NA,70,8173
46067,"South Dakota","Hutchinson",692,2517,112,NA,44,3365
46069,"South Dakota","Hyde",125,543,17,NA,5,690
46071,"South Dakota","Jackson",323,722,36,NA,14,1095
46073,"South Dakota","Jerauld",264,648,36,NA,19,967
46075,"South Dakota","Jones",69,450,32,NA,7,558
46077,"South Dakota","Kingsbury",703,1680,139,NA,29,2551
46079,"South Dakota","Lake",2314,4038,358,NA,76,6786
46081,"South Dakota","Lawrence",3356,7411,934,NA,141,11842
46083,"South Dakota","Lincoln",8076,15499,1413,NA,243,25231
46085,"South Dakota","Lyman",369,977,56,NA,19,1421
46087,"South Dakota","McCook",623,1794,130,NA,40,2587
46089,"South Dakota","McPherson",192,892,43,NA,10,1137
46091,"South Dakota","Marshall",754,1056,117,NA,20,1947
46093,"South Dakota","Meade",2223,8441,832,NA,125,11621
46095,"South Dakota","Mellette",238,402,32,NA,11,683
46097,"South Dakota","Miner",281,706,67,NA,10,1064
46099,"South Dakota","Minnehaha",30610,42043,4753,NA,857,78263
46101,"South Dakota","Moody",1042,1729,131,NA,28,2930
46103,"South Dakota","Pennington",14074,29804,3338,NA,525,47741
46105,"South Dakota","Perkins",188,1333,70,NA,15,1606
46107,"South Dakota","Potter",215,1069,40,NA,11,1335
46109,"South Dakota","Roberts",1539,2142,164,NA,41,3886
46111,"South Dakota","Sanborn",241,819,51,NA,12,1123
46113,"South Dakota","Oglala Lakota",2504,241,104,NA,47,2896
46115,"South Dakota","Spink",919,1854,143,NA,35,2951
46117,"South Dakota","Stanley",329,1148,77,NA,13,1567
46119,"South Dakota","Sully",137,679,40,NA,5,861
46121,"South Dakota","Todd",1505,487,96,NA,37,2125
46123,"South Dakota","Tripp",462,2069,84,NA,15,2630
46125,"South Dakota","Turner",961,2937,216,NA,36,4150
46127,"South Dakota","Union",2227,5288,312,NA,68,7895
46129,"South Dakota","Walworth",457,1896,79,NA,45,2477
46135,"South Dakota","Yankton",3301,5654,551,NA,110,9616
46137,"South Dakota","Ziebach",352,368,28,NA,18,766
47001,"Tennessee","Anderson",9013,19212,1034,189,433,29881
47003,"Tennessee","Bedford",3395,11486,306,75,93,15355
47005,"Tennessee","Benton",1474,4716,83,14,41,6328
47007,"Tennessee","Bledsoe",897,3622,95,18,32,4664
47009,"Tennessee","Blount",12100,37443,1666,313,686,52208
47011,"Tennessee","Bradley",7070,29768,1098,210,520,38666
47013,"Tennessee","Campbell",2248,9870,251,45,118,12532
47015,"Tennessee","Cannon",1127,4007,106,29,45,5314
47017,"Tennessee","Carroll",2327,7756,181,39,81,10384
47019,"Tennessee","Carter",3453,16898,409,130,194,21084
47021,"Tennessee","Cheatham",3878,11297,463,99,187,15924
47023,"Tennessee","Chester",1243,5081,115,10,58,6507
47025,"Tennessee","Claiborne",1832,8602,192,29,85,10740
47027,"Tennessee","Clay",707,2141,47,11,14,2920
47029,"Tennessee","Cocke",1981,9791,211,59,84,12126
47031,"Tennessee","Coffee",4743,14417,517,113,181,19971
47033,"Tennessee","Crockett",1303,3982,76,13,23,5397
47035,"Tennessee","Cumberland",5202,20413,471,99,175,26360
47037,"Tennessee","Davidson",148864,84550,9603,2459,3592,249068
47039,"Tennessee","Decatur",894,3588,70,16,24,4592
47041,"Tennessee","DeKalb",1569,5171,117,49,49,6955
47043,"Tennessee","Dickson",4722,13233,489,94,161,18699
47045,"Tennessee","Dyer",2816,10180,193,48,99,13336
47047,"Tennessee","Fayette",5874,13055,261,62,142,19394
47049,"Tennessee","Fentress",1100,6038,107,37,51,7333
47051,"Tennessee","Franklin",4374,11532,319,66,113,16404
47053,"Tennessee","Gibson",5258,13786,305,66,132,19547
47055,"Tennessee","Giles",2917,7970,162,41,47,11137
47057,"Tennessee","Grainger",1154,6626,130,26,72,8008
47059,"Tennessee","Greene",4216,18562,481,152,172,23583
47061,"Tennessee","Grundy",999,3636,80,19,29,4763
47063,"Tennessee","Hamblen",4075,15857,443,93,224,20692
47065,"Tennessee","Hamilton",55316,78733,5443,1098,1818,142408
47067,"Tennessee","Hancock",322,1843,42,13,11,2231
47069,"Tennessee","Hardeman",4185,4919,84,30,55,9273
47071,"Tennessee","Hardin",1622,8012,134,96,85,9949
47073,"Tennessee","Hawkins",3507,16648,397,91,131,20774
47075,"Tennessee","Haywood",3711,3013,60,19,31,6834
47077,"Tennessee","Henderson",1800,8138,172,39,68,10217
47079,"Tennessee","Henry",3063,9508,223,60,91,12945
47081,"Tennessee","Hickman",1824,5695,161,39,94,7813
47083,"Tennessee","Houston",866,2182,88,12,20,3168
47085,"Tennessee","Humphreys",1967,4930,166,26,64,7153
47087,"Tennessee","Jackson",1129,3236,62,17,22,4466
47089,"Tennessee","Jefferson",3494,14776,497,115,190,19072
47091,"Tennessee","Johnson",988,5410,102,39,40,6579
47093,"Tennessee","Knox",62878,105767,7458,1634,2960,180697
47095,"Tennessee","Lake",577,1357,18,6,12,1970
47097,"Tennessee","Lauderdale",3056,4884,87,14,46,8087
47099,"Tennessee","Lawrence",2821,12420,271,77,77,15666
47101,"Tennessee","Lewis",890,3585,59,42,46,4622
47103,"Tennessee","Lincoln",2554,10398,231,46,119,13348
47105,"Tennessee","Loudon",4919,17610,573,87,202,23391
47107,"Tennessee","McMinn",3510,14691,340,69,145,18755
47109,"Tennessee","McNairy",1848,7841,150,110,89,10038
47111,"Tennessee","Macon",1072,6263,91,36,42,7504
47113,"Tennessee","Madison",15448,21335,660,140,537,38120
47115,"Tennessee","Marion",2832,7696,221,50,63,10862
47117,"Tennessee","Marshall",2852,8184,256,60,103,11455
47119,"Tennessee","Maury",10038,23799,922,166,444,35369
47121,"Tennessee","Meigs",856,3342,77,19,26,4320
47123,"Tennessee","Monroe",3186,13374,345,58,130,17093
47125,"Tennessee","Montgomery",21699,32341,2337,540,703,57620
47127,"Tennessee","Moore",496,2325,71,17,17,2926
47129,"Tennessee","Morgan",1054,5441,115,17,78,6705
47131,"Tennessee","Obion",2426,9526,193,36,68,12249
47133,"Tennessee","Overton",1945,6059,111,31,83,8229
47135,"Tennessee","Perry",597,2167,59,23,9,2855
47137,"Tennessee","Pickett",536,2021,36,7,15,2615
47139,"Tennessee","Polk",1252,5097,114,26,31,6520
47141,"Tennessee","Putnam",6851,19002,757,225,377,27212
47143,"Tennessee","Rhea",1942,8660,221,35,204,11062
47145,"Tennessee","Roane",4837,15880,596,102,254,21669
47147,"Tennessee","Robertson",6637,19410,717,161,188,27113
47149,"Tennessee","Rutherford",36706,64515,3916,894,1405,107436
47151,"Tennessee","Scott",934,6044,80,21,44,7123
47153,"Tennessee","Sequatchie",1053,4441,128,25,47,5694
47155,"Tennessee","Sevier",6297,28629,915,212,259,36312
47157,"Tennessee","Shelby",208992,116344,6939,1986,3122,337383
47159,"Tennessee","Smith",1689,5494,171,30,52,7436
47161,"Tennessee","Stewart",1222,3864,147,21,45,5299
47163,"Tennessee","Sullivan",12578,46979,1793,355,573,62278
47165,"Tennessee","Sumner",18161,50129,2102,369,744,71505
47167,"Tennessee","Tipton",5785,16910,485,90,211,23481
47169,"Tennessee","Trousdale",946,2103,73,6,32,3160
47171,"Tennessee","Unicoi",1262,5671,139,53,70,7195
47173,"Tennessee","Union",1012,5053,108,24,50,6247
47175,"Tennessee","Van Buren",539,1820,46,8,6,2419
47177,"Tennessee","Warren",3535,9540,339,61,137,13612
47179,"Tennessee","Washington",13024,34252,1468,478,528,49750
47181,"Tennessee","Wayne",717,5036,56,9,39,5857
47183,"Tennessee","Weakley",2772,9008,220,62,122,12184
47185,"Tennessee","White",1845,7671,149,45,115,9825
47187,"Tennessee","Williamson",31013,68212,4518,526,2002,106271
47189,"Tennessee","Wilson",14385,39406,1807,467,669,56734
48001,"Texas","ANDERSON",3369,13201,308,57,42,16977
48003,"Texas","ANDREWS",836,3927,147,18,15,4943
48005,"Texas","ANGELINA",7538,21668,560,106,39,29911
48007,"Texas","ARANSAS",2465,7740,238,41,28,10512
48009,"Texas","ARCHER",394,3786,80,10,13,4283
48011,"Texas","ARMSTRONG",70,924,18,5,4,1021
48013,"Texas","ATASCOSA",4651,8618,308,65,31,13673
48015,"Texas","AUSTIN",2320,9637,248,51,18,12274
48017,"Texas","BAILEY",397,1344,39,5,8,1793
48019,"Texas","BANDERA",1726,8163,262,66,1,10218
48021,"Texas","BASTROP",10569,16328,1063,320,174,28454
48023,"Texas","BAYLOR",191,1267,31,3,7,1499
48025,"Texas","BEE",3444,4744,238,34,25,8485
48027,"Texas","BELL",37801,51998,3824,812,559,94994
48029,"Texas","BEXAR",319550,240333,20091,6645,3026,589645
48031,"Texas","BLANCO",1244,4212,180,33,16,5685
48033,"Texas","BORDEN",31,330,3,1,0,365
48035,"Texas","BOSQUE",1278,6339,155,40,26,7838
48037,"Texas","BOWIE",8838,24924,582,145,113,34602
48039,"Texas","BRAZORIA",43200,72791,3768,806,616,121181
48041,"Texas","BRAZOS",23121,38738,3813,536,1003,67211
48043,"Texas","BREWSTER",1873,2077,210,77,15,4252
48045,"Texas","BRISCOE",91,625,14,4,2,736
48047,"Texas","BROOKS",1937,613,32,14,0,2596
48049,"Texas","BROWN",1621,12017,253,65,70,14026
48051,"Texas","BURLESON",1491,5316,118,20,15,6960
48053,"Texas","BURNET",3797,14638,564,104,101,19204
48055,"Texas","CALDWELL",4795,6691,446,105,55,12092
48057,"Texas","CALHOUN",2118,4638,168,33,8,6965
48059,"Texas","CALLAHAN",569,4865,107,23,15,5579
48061,"Texas","CAMERON",59402,29472,2236,822,147,92079
48063,"Texas","CAMP",1260,3201,66,15,0,4542
48065,"Texas","CARSON",249,2620,68,11,16,2964
48067,"Texas","CASS",2391,9726,145,34,48,12344
48069,"Texas","CASTRO",526,1414,47,10,0,1997
48071,"Texas","CHAMBERS",2948,13339,385,59,55,16786
48073,"Texas","CHEROKEE",3469,12919,305,34,63,16790
48075,"Texas","CHILDRESS",253,1802,24,5,0,2084
48077,"Texas","CLAY",536,4377,87,12,6,5018
48079,"Texas","COCHRAN",190,679,29,3,0,901
48081,"Texas","COKE",140,1265,16,2,0,1423
48083,"Texas","COLEMAN",388,3177,53,18,7,3643
48085,"Texas","COLLIN",140624,201014,13855,2539,3387,361419
48087,"Texas","COLLINGSWORTH",145,983,22,4,2,1156
48089,"Texas","COLORADO",1987,6325,144,37,20,8513
48091,"Texas","COMAL",14238,45136,2068,343,393,62178
48093,"Texas","COMANCHE",789,4333,88,21,6,5237
48095,"Texas","CONCHO",148,885,27,7,1,1068
48097,"Texas","COOKE",2352,13181,317,60,45,15955
48099,"Texas","CORYELL",5064,12225,704,161,99,18253
48101,"Texas","COTTLE",92,506,12,2,0,612
48103,"Texas","CRANE",299,1049,28,7,1,1384
48105,"Texas","CROCKETT",372,980,39,4,0,1395
48107,"Texas","CROSBY",468,1181,60,5,14,1728
48109,"Texas","CULBERSON",454,280,23,6,4,767
48111,"Texas","DALLAM",222,1261,46,9,6,1544
48113,"Texas","DALLAS",461080,262945,24025,6114,4809,758973
48115,"Texas","DAWSON",835,2636,80,11,1,3563
48117,"Texas","DEAF SMITH",1185,2911,91,14,15,4216
48119,"Texas","DELTA",400,1836,36,7,2,2281
48121,"Texas","DENTON",110890,170603,11583,2660,2909,298645
48123,"Texas","DEWITT",1163,5519,124,27,11,6844
48125,"Texas","DICKENS",128,755,23,3,0,909
48127,"Texas","DIMMIT",2173,974,57,21,0,3225
48129,"Texas","DONLEY",191,1225,40,5,4,1465
48131,"Texas","DUVAL",2783,1316,49,19,1,4168
48133,"Texas","EASTLAND",776,6011,120,31,25,6963
48135,"Texas","ECTOR",10249,25020,1009,167,85,36530
48137,"Texas","EDWARDS",303,746,17,5,2,1073
48139,"Texas","ELLIS",16253,44941,1747,325,407,63673
48141,"Texas","EL PASO",147843,55512,7607,2945,101,214008
48143,"Texas","ERATH",2160,11210,378,68,77,13893
48145,"Texas","FALLS",1684,3441,90,23,10,5248
48147,"Texas","FANNIN",2132,9548,269,46,49,12044
48149,"Texas","FAYETTE",2144,8743,209,45,33,11174
48151,"Texas","FISHER",403,1265,44,10,7,1729
48153,"Texas","FLOYD",435,1474,47,3,0,1959
48155,"Texas","FOARD",113,383,14,1,2,513
48157,"Texas","FORT BEND",134686,117291,6907,1783,1399,262066
48159,"Texas","FRANKLIN",665,3585,96,12,22,4380
48161,"Texas","FREESTONE",1471,6026,139,13,35,7684
48163,"Texas","FRIO",2444,1856,76,24,0,4400
48165,"Texas","GAINES",597,3907,85,20,11,4620
48167,"Texas","GALVESTON",43658,73757,4045,889,554,122903
48169,"Texas","GARZA",230,1225,21,7,1,1484
48171,"Texas","GILLESPIE",2288,10446,333,61,86,13214
48173,"Texas","GLASSCOCK",34,553,13,2,2,604
48175,"Texas","GOLIAD",973,2620,101,10,4,3708
48177,"Texas","GONZALES",1571,4587,129,28,19,6334
48179,"Texas","GRAY",701,6500,144,22,38,7405
48181,"Texas","GRAYSON",10301,35325,1258,264,268,47416
48183,"Texas","GREGG",11677,28764,903,150,255,41749
48185,"Texas","GRIMES",2194,7065,219,50,5,9533
48187,"Texas","GUADALUPE",18391,36632,2022,412,365,57822
48189,"Texas","HALE",2101,6366,324,43,24,8858
48191,"Texas","HALL",164,893,34,0,0,1091
48193,"Texas","HAMILTON",479,3060,64,10,7,3620
48195,"Texas","HANSFORD",171,1730,37,9,0,1947
48197,"Texas","HARDEMAN",249,1207,48,7,2,1513
48199,"Texas","HARDIN",2780,19606,353,41,0,22780
48201,"Texas","HARRIS",707914,545955,39781,11784,6678,1312112
48203,"Texas","HARRISON",7151,18749,449,76,123,26548
48205,"Texas","HARTLEY",173,1730,43,3,3,1952
48207,"Texas","HASKELL",314,1403,42,6,5,1770
48209,"Texas","HAYS",33224,33826,3630,1061,423,72164
48211,"Texas","HEMPHILL",181,1462,44,2,6,1695
48213,"Texas","HENDERSON",5669,23650,535,102,89,30045
48215,"Texas","HIDALGO",118809,48642,3788,1856,342,173437
48217,"Texas","HILL",2547,10108,256,40,19,12970
48219,"Texas","HOCKLEY",1260,5809,199,33,10,7311
48221,"Texas","HOOD",4008,21382,641,113,118,26262
48223,"Texas","HOPKINS",2510,10707,220,44,57,13538
48225,"Texas","HOUSTON",1978,6205,90,29,51,8353
48227,"Texas","HOWARD",1770,6637,232,56,28,8723
48229,"Texas","HUDSPETH",324,503,38,6,0,871
48231,"Texas","HUNT",6396,23910,862,162,224,31554
48233,"Texas","HUTCHINSON",854,7042,210,23,26,8155
48235,"Texas","IRION",90,660,9,1,6,766
48237,"Texas","JACK",314,2973,42,10,11,3350
48239,"Texas","JACKSON",904,4266,78,27,27,5302
48241,"Texas","JASPER",2590,10609,156,38,26,13419
48243,"Texas","JEFF DAVIS",422,695,42,17,15,1191
48245,"Texas","JEFFERSON",42443,42862,1714,420,179,87618
48247,"Texas","JIM HOGG",1635,430,42,12,0,2119
48249,"Texas","JIM WELLS",6694,5420,210,40,15,12379
48251,"Texas","JOHNSON",10988,44382,1605,324,307,57606
48253,"Texas","JONES",936,4819,162,21,22,5960
48255,"Texas","KARNES",1145,2965,70,12,6,4198
48257,"Texas","KAUFMAN",10278,29587,983,197,220,41265
48259,"Texas","KENDALL",3643,15700,555,87,135,20120
48261,"Texas","KENEDY",99,84,3,0,0,186
48263,"Texas","KENT",59,360,14,0,1,434
48265,"Texas","KERR",4681,17727,657,116,116,23297
48267,"Texas","KIMBLE",206,1697,37,5,7,1952
48269,"Texas","KING",5,149,5,0,0,159
48271,"Texas","KINNEY",458,936,25,6,5,1430
48273,"Texas","KLEBERG",4716,4367,314,92,23,9512
48275,"Texas","KNOX",247,1078,28,5,9,1367
48277,"Texas","LAMAR",3583,14561,343,70,54,18611
48279,"Texas","LAMB",771,3111,85,8,20,3995
48281,"Texas","LAMPASAS",1483,6385,253,47,37,8205
48283,"Texas","LASALLE",1129,872,44,10,4,2059
48285,"Texas","LAVACA",1170,7347,112,12,20,8661
48287,"Texas","LEE",1372,4997,126,28,12,6535
48289,"Texas","LEON",909,6391,94,13,32,7439
48291,"Texas","LIBERTY",4862,18892,364,85,64,24267
48293,"Texas","LIMESTONE",1778,5796,128,27,10,7739
48295,"Texas","LIPSCOMB",135,1159,25,3,10,1332
48297,"Texas","LIVE OAK",742,3464,65,13,18,4302
48299,"Texas","LLANO",1825,8299,205,65,53,10447
48301,"Texas","LOVING",4,58,1,2,0,65
48303,"Texas","LUBBOCK",28023,65651,3917,633,789,99013
48305,"Texas","LYNN",403,1546,41,7,12,2009
48307,"Texas","MCCULLOCH",482,2552,51,9,9,3103
48309,"Texas","MCLENNAN",27063,48260,2492,473,787,79075
48311,"Texas","MCMULLEN",40,454,2,1,2,499
48313,"Texas","MADISON",881,3351,45,8,4,4289
48315,"Texas","MARION",1165,2983,71,13,6,4238
48317,"Texas","MARTIN",266,1455,31,5,5,1762
48319,"Texas","MASON",354,1656,37,7,3,2057
48321,"Texas","MATAGORDA",3500,8366,239,53,38,12196
48323,"Texas","MAVERICK",10397,2816,266,109,0,13588
48325,"Texas","MEDINA",4634,12085,403,106,18,17246
48327,"Texas","MENARD",154,682,25,1,2,864
48329,"Texas","MIDLAND",10025,36973,1667,203,344,49212
48331,"Texas","MILAM",2051,6364,178,49,22,8664
48333,"Texas","MILLS",243,1951,41,6,4,2245
48335,"Texas","MITCHELL",354,1780,50,7,5,2196
48337,"Texas","MONTAGUE",885,7526,170,23,0,8604
48339,"Texas","MONTGOMERY",45835,150314,6142,1018,1323,204632
48341,"Texas","MOORE",1098,3977,166,26,17,5284
48343,"Texas","MORRIS",1425,3446,77,19,6,4973
48345,"Texas","MOTLEY",40,566,9,0,0,615
48347,"Texas","NACOGDOCHES",6846,14771,702,159,144,22622
48349,"Texas","NAVARRO",4002,11994,343,58,36,16433
48351,"Texas","NEWTON",1156,4288,66,13,11,5534
48353,"Texas","NOLAN",1029,3552,142,22,112,4857
48355,"Texas","NUECES",49198,50766,3324,847,270,104405
48357,"Texas","OCHILTREE",274,2628,75,5,20,3002
48359,"Texas","OLDHAM",78,850,14,3,3,948
48361,"Texas","ORANGE",5735,25513,550,115,87,32000
48363,"Texas","PALO PINTO",1708,8284,210,48,20,10270
48365,"Texas","PANOLA",1835,8445,109,24,3,10416
48367,"Texas","PARKER",8344,46473,1439,215,346,56817
48369,"Texas","PARMER",485,1915,55,4,7,2466
48371,"Texas","PECOS",1554,2468,127,26,10,4185
48373,"Texas","POLK",4187,15176,367,86,36,19852
48375,"Texas","POTTER",7657,19630,1028,190,146,28651
48377,"Texas","PRESIDIO",1458,652,64,29,5,2208
48379,"Texas","RAINS",628,3968,80,15,10,4701
48381,"Texas","RANDALL",8367,43462,1872,228,376,54305
48383,"Texas","REAGAN",167,709,22,2,4,904
48385,"Texas","REAL",262,1382,28,6,3,1681
48387,"Texas","RED RIVER",1149,3926,67,8,11,5161
48389,"Texas","REEVES",1659,1417,98,10,0,3184
48391,"Texas","REFUGIO",1034,1830,71,10,3,2948
48393,"Texas","ROBERTS",20,524,6,0,4,554
48395,"Texas","ROBERTSON",2203,4668,125,17,22,7035
48397,"Texas","ROCKWALL",9655,28451,1305,207,330,39948
48399,"Texas","RUNNELS",453,3250,60,13,6,3782
48401,"Texas","RUSK",3935,14675,333,51,0,18994
48403,"Texas","SABINE",614,3998,27,9,3,4651
48405,"Texas","SAN AUGUSTINE",910,2622,30,6,1,3569
48407,"Texas","SAN JACINTO",2038,8059,170,52,24,10343
48409,"Texas","SAN PATRICIO",7871,13030,573,113,69,21656
48411,"Texas","SAN SABA",293,2025,32,4,3,2357
48413,"Texas","SCHLEICHER",208,821,24,3,3,1059
48415,"Texas","SCURRY",733,4410,103,22,21,5289
48417,"Texas","SHACKELFORD",103,1378,21,0,2,1504
48419,"Texas","SHELBY",1758,7179,123,21,5,9086
48421,"Texas","SHERMAN",96,807,27,3,2,935
48423,"Texas","SMITH",22300,58930,2076,341,1121,84768
48425,"Texas","SOMERVELL",541,3206,107,23,20,3897
48427,"Texas","STARR",9289,2224,159,68,0,11740
48429,"Texas","STEPHENS",348,3034,65,7,7,3461
48431,"Texas","STERLING",70,549,9,5,0,633
48433,"Texas","STONEWALL",135,555,10,1,0,701
48435,"Texas","SUTTON",313,1075,22,5,1,1416
48437,"Texas","SWISHER",462,1671,51,6,14,2204
48439,"Texas","TARRANT",288392,345921,23775,5413,5013,668514
48441,"Texas","TAYLOR",10085,33250,1763,289,372,45759
48443,"Texas","TERRELL",140,288,10,0,0,438
48445,"Texas","TERRY",753,2459,112,21,10,3355
48447,"Texas","THROCKMORTON",84,715,7,2,0,808
48449,"Texas","TITUS",2597,6511,191,44,76,9419
48451,"Texas","TOM GREEN",9173,27494,1402,218,192,38479
48453,"Texas","TRAVIS",308260,127209,21958,7462,3831,468720
48455,"Texas","TRINITY",1154,4737,80,11,3,5985
48457,"Texas","TYLER",1248,6624,103,22,19,8016
48459,"Texas","UPSHUR",2380,13209,283,59,82,16013
48461,"Texas","UPTON",286,1007,49,3,2,1347
48463,"Texas","UVALDE",3867,4835,191,54,17,8964
48465,"Texas","VAL VERDE",6964,5890,573,131,59,13617
48467,"Texas","VAN ZANDT",2799,18473,385,77,156,21890
48469,"Texas","VICTORIA",8866,21275,782,156,44,31123
48471,"Texas","WALKER",6091,12884,560,161,100,19796
48473,"Texas","WALLER",5748,10531,342,104,59,16784
48475,"Texas","WARD",783,2547,82,10,23,3445
48477,"Texas","WASHINGTON",3382,10945,352,70,79,14828
48479,"Texas","WEBB",42307,12947,1033,591,27,56905
48481,"Texas","WHARTON",4238,10149,269,51,25,14732
48483,"Texas","WHEELER",194,2087,21,4,0,2306
48485,"Texas","WICHITA",8770,27631,1308,256,154,38119
48487,"Texas","WILBARGER",809,3166,115,13,2,4105
48489,"Texas","WILLACY",3422,1547,95,31,0,5095
48491,"Texas","WILLIAMSON",84468,104175,10229,2047,2162,203081
48493,"Texas","WILSON",4790,13998,392,82,170,19432
48495,"Texas","WINKLER",420,1403,49,1,3,1876
48497,"Texas","WISE",3412,20670,505,91,98,24776
48499,"Texas","WOOD",2630,15700,280,64,53,18727
48501,"Texas","YOAKUM",426,1797,73,3,4,2303
48503,"Texas","YOUNG",876,6601,180,19,31,7707
48505,"Texas","ZAPATA",2063,1029,34,16,0,3142
48507,"Texas","ZAVALA",2636,694,50,16,0,3396
49001,"Utah","Beaver",264,1838,36,10,343,2491
49003,"Utah","Box Elder",2282,12230,591,76,4556,19735
49005,"Utah","Cache",8563,21139,1630,330,14495,46157
49007,"Utah","Carbon",1717,5275,191,41,728,7952
49009,"Utah","Daggett",77,331,17,0,49,474
49011,"Utah","Davis",28776,62219,5390,864,41162,138411
49013,"Utah","Duchesne",500,5508,107,18,809,6942
49015,"Utah","Emery",380,3425,71,3,410,4289
49017,"Utah","Garfield",358,1606,61,16,303,2344
49019,"Utah","Grand",1960,1975,180,109,309,4533
49021,"Utah","Iron",2450,11561,540,102,3001,17654
49023,"Utah","Juab",442,2827,72,14,822,4177
49025,"Utah","Kane",741,2265,86,31,382,3505
49027,"Utah","Millard",431,3860,108,6,837,5242
49029,"Utah","Morgan",577,3188,142,11,1274,5192
49031,"Utah","Piute",47,626,11,1,44,729
49033,"Utah","Rich",104,797,21,1,186,1109
49035,"Utah","Salt Lake",175863,138043,16306,4965,83691,418868
49037,"Utah","San Juan",2042,2645,165,47,548,5447
49039,"Utah","Sanpete",1061,6673,186,30,2214,10164
49041,"Utah","Sevier",695,6740,175,29,1015,8654
49043,"Utah","Summit",10503,7333,756,170,1879,20641
49045,"Utah","Tooele",4573,11169,783,182,5122,21829
49047,"Utah","Uintah",995,9810,275,43,1674,12797
49049,"Utah","Utah",28522,102182,6437,1030,63380,201551
49051,"Utah","Wasatch",3063,6115,409,70,2463,12120
49053,"Utah","Washington",10288,42650,1473,290,7262,61963
49055,"Utah","Wayne",271,966,18,12,154,1421
49057,"Utah","Weber",23131,40235,3371,937,17365,85039
50001,"Vermont","ADDISON",324,337,47,8,59,775
50001,"Vermont","BRIDPORT",292,278,24,8,53,655
50001,"Vermont","BRISTOL",1075,558,60,41,192,1926
50001,"Vermont","CORNWALL",517,147,22,14,37,737
50001,"Vermont","FERRISBURGH",892,501,61,21,132,1607
50001,"Vermont","GOSHEN",78,31,6,3,5,123
50001,"Vermont","GRANVILLE",82,29,3,6,28,148
50001,"Vermont","HANCOCK",75,54,6,4,20,159
50001,"Vermont","LEICESTER",217,207,15,5,48,492
50001,"Vermont","LINCOLN",494,188,22,27,60,791
50001,"Vermont","MIDDLEBURY",2682,595,77,71,242,3667
50001,"Vermont","MONKTON",671,360,57,16,98,1202
50001,"Vermont","NEW HAVEN",594,337,45,21,81,1078
50001,"Vermont","ORWELL",270,284,29,16,49,648
50001,"Vermont","PANTON",171,126,6,6,29,338
50001,"Vermont","RIPTON",228,58,5,13,31,335
50001,"Vermont","SALISBURY",296,189,8,9,53,555
50001,"Vermont","SHOREHAM",356,211,19,13,51,650
50001,"Vermont","STARKSBORO",534,256,36,24,81,931
50001,"Vermont","VERGENNES",712,326,51,23,107,1219
50001,"Vermont","WALTHAM",149,83,14,2,27,275
50001,"Vermont","WEYBRIDGE",415,74,18,8,8,523
50001,"Vermont","WHITING",95,68,8,2,24,197
50003,"Vermont","ARLINGTON",662,435,28,22,121,1268
50003,"Vermont","BENNINGTON",3361,1949,155,147,413,6025
50003,"Vermont","DORSET",740,334,36,18,61,1189
50003,"Vermont","LANDGROVE",71,18,5,1,8,103
50003,"Vermont","MANCHESTER",1452,706,74,33,128,2393
50003,"Vermont","PERU",166,54,4,2,5,231
50003,"Vermont","POWNAL",761,681,47,29,110,1628
50003,"Vermont","READSBORO",166,173,7,7,26,379
50003,"Vermont","RUPERT",213,138,14,6,20,391
50003,"Vermont","SANDGATE",99,95,6,7,10,217
50003,"Vermont","SEARSBURG",19,36,0,0,3,58
50003,"Vermont","SHAFTSBURY",952,661,53,26,122,1814
50003,"Vermont","STAMFORD",203,238,16,6,11,474
50003,"Vermont","SUNDERLAND",281,183,12,6,35,517
50003,"Vermont","WINHALL",299,158,15,7,38,517
50003,"Vermont","WOODFORD",94,66,6,1,10,177
50005,"Vermont","BARNET",485,355,46,21,54,961
50005,"Vermont","BURKE",381,336,34,13,59,823
50005,"Vermont","DANVILLE",645,494,50,22,98,1309
50005,"Vermont","GROTON",159,234,18,16,56,483
50005,"Vermont","HARDWICK",651,501,42,49,133,1376
50005,"Vermont","KIRBY",125,96,6,8,28,263
50005,"Vermont","LYNDON",827,883,86,43,223,2062
50005,"Vermont","NEWARK",130,116,16,13,26,301
50005,"Vermont","PEACHAM",291,113,25,11,32,472
50005,"Vermont","RYEGATE",252,239,15,12,19,537
50005,"Vermont","SAINT JOHNSBURY",1469,1110,125,64,242,3010
50005,"Vermont","SHEFFIELD",110,131,14,6,42,303
50005,"Vermont","STANNARD",58,22,5,1,14,100
50005,"Vermont","SUTTON",168,220,24,11,3,426
50005,"Vermont","WALDEN",246,168,22,25,58,519
50005,"Vermont","WATERFORD",292,341,37,5,61,736
50005,"Vermont","WHEELOCK",156,175,13,13,37,394
50007,"Vermont","BOLTON",389,205,14,8,58,674
50007,"Vermont","BURLINGTON",14519,2082,412,689,1236,18938
50007,"Vermont","CHARLOTTE",1794,512,79,54,125,2564
50007,"Vermont","COLCHESTER",4483,2425,245,120,490,7763
50007,"Vermont","ESSEX",6753,3030,418,155,853,11209
50007,"Vermont","HINESBURG",1726,623,81,57,177,2664
50007,"Vermont","HUNTINGTON",796,232,44,35,132,1239
50007,"Vermont","JERICHO",2017,890,101,54,263,3325
50007,"Vermont","MILTON",2260,2085,149,70,506,5070
50007,"Vermont","RICHMOND",1694,515,100,49,166,2524
50007,"Vermont","SAINT GEORGE",200,110,7,6,35,358
50007,"Vermont","SHELBURNE",3390,941,111,79,265,4786
50007,"Vermont","SOUTH BURLINGTON",7246,2059,322,196,577,10400
50007,"Vermont","UNDERHILL",1238,504,55,26,141,1964
50007,"Vermont","WESTFORD",696,371,58,22,122,1269
50007,"Vermont","WILLISTON",3508,1481,195,69,349,5602
50007,"Vermont","WINOOSKI",2105,536,78,107,243,3069
50009,"Vermont","BLOOMFIELD",30,52,8,6,14,110
50009,"Vermont","BRIGHTON",229,276,17,8,30,560
50009,"Vermont","BRUNSWICK",21,28,2,0,5,56
50009,"Vermont","CANAAN",179,207,12,2,30,430
50009,"Vermont","CONCORD",181,292,30,3,58,564
50009,"Vermont","EAST HAVEN",51,70,2,6,17,146
50009,"Vermont","GRANBY",12,22,1,3,3,41
50009,"Vermont","GUILDHALL",40,76,10,3,15,144
50009,"Vermont","LEMINGTON",18,28,6,1,2,55
50009,"Vermont","LUNENBURG",171,311,20,9,42,553
50009,"Vermont","MAIDSTONE",39,60,6,1,11,117
50009,"Vermont","NORTON",30,46,4,0,4,84
50009,"Vermont","VICTORY",18,38,3,1,5,65
50011,"Vermont","BAKERSFIELD",295,209,22,10,61,597
50011,"Vermont","BERKSHIRE",209,308,26,5,61,609
50011,"Vermont","ENOSBURGH",502,429,57,22,185,1195
50011,"Vermont","FAIRFAX",1063,947,113,42,200,2365
50011,"Vermont","FAIRFIELD",489,338,41,12,64,944
50011,"Vermont","FLETCHER",336,240,31,23,71,701
50011,"Vermont","FRANKLIN",229,296,33,4,66,628
50011,"Vermont","GEORGIA",1019,1023,90,38,227,2397
50011,"Vermont","HIGHGATE",474,699,42,11,160,1386
50011,"Vermont","MONTGOMERY",302,231,21,19,85,658
50011,"Vermont","RICHFORD",324,388,21,15,79,827
50011,"Vermont","SAINT ALBANS CITY",1287,807,120,43,248,2505
50011,"Vermont","SAINT ALBANS TOWN",1416,1268,106,32,292,3114
50011,"Vermont","SHELDON",305,377,31,11,91,815
50011,"Vermont","SWANTON",1101,1192,82,33,262,2670
50013,"Vermont","ALBURGH",372,399,29,8,80,888
50013,"Vermont","GRAND ISLE",594,431,39,13,97,1174
50013,"Vermont","ISLE LA MOTTE",136,140,12,5,14,307
50013,"Vermont","NORTH HERO",320,216,15,6,64,621
50013,"Vermont","SOUTH HERO",672,301,36,18,93,1120
50015,"Vermont","BELVIDERE",53,85,7,1,12,158
50015,"Vermont","CAMBRIDGE",1067,520,89,41,211,1928
50015,"Vermont","EDEN",221,241,17,18,64,561
50015,"Vermont","ELMORE",339,132,19,16,35,541
50015,"Vermont","HYDE PARK",788,475,48,37,183,1531
50015,"Vermont","JOHNSON",691,395,45,48,143,1322
50015,"Vermont","MORRISTOWN",1550,741,81,89,246,2707
50015,"Vermont","STOWE",1974,559,113,39,156,2841
50015,"Vermont","WATERVILLE",161,146,14,10,44,375
50015,"Vermont","WOLCOTT",397,276,24,27,74,798
50017,"Vermont","BRADFORD",624,409,42,23,98,1196
50017,"Vermont","BRAINTREE",289,217,21,9,57,593
50017,"Vermont","BROOKFIELD",378,231,34,26,80,749
50017,"Vermont","CHELSEA",304,273,22,12,49,660
50017,"Vermont","CORINTH",308,264,19,14,72,677
50017,"Vermont","FAIRLEE",350,149,17,11,39,566
50017,"Vermont","NEWBURY",528,403,28,21,84,1064
50017,"Vermont","ORANGE",186,265,22,17,48,538
50017,"Vermont","RANDOLPH",1160,737,78,67,212,2254
50017,"Vermont","STRAFFORD",500,105,24,30,34,693
50017,"Vermont","THETFORD",1145,324,45,34,97,1645
50017,"Vermont","TOPSHAM",226,274,19,8,47,574
50017,"Vermont","TUNBRIDGE",349,242,21,22,68,702
50017,"Vermont","VERSHIRE",189,118,10,18,29,364
50017,"Vermont","WASHINGTON",217,241,24,11,43,536
50017,"Vermont","WEST FAIRLEE",161,97,15,2,22,297
50017,"Vermont","WILLIAMSTOWN",627,658,72,25,159,1541
50019,"Vermont","ALBANY",207,183,13,9,38,450
50019,"Vermont","BARTON",502,425,32,5,105,1069
50019,"Vermont","BROWNINGTON",146,193,8,2,42,391
50019,"Vermont","CHARLESTON",184,210,17,13,40,464
50019,"Vermont","COVENTRY",196,244,16,5,49,510
50019,"Vermont","CRAFTSBURY",435,153,26,25,48,687
50019,"Vermont","DERBY",885,1004,82,36,175,2182
50019,"Vermont","GLOVER",290,193,31,15,56,585
50019,"Vermont","GREENSBORO",271,96,12,11,36,426
50019,"Vermont","HOLLAND",81,175,10,2,34,302
50019,"Vermont","IRASBURG",194,284,27,2,47,554
50019,"Vermont","JAY",113,101,6,3,22,245
50019,"Vermont","LOWELL",123,250,11,4,45,433
50019,"Vermont","MORGAN",101,197,10,2,27,337
50019,"Vermont","NEWPORT CITY",721,614,34,19,155,1543
50019,"Vermont","NEWPORT TOWN",256,338,31,16,62,703
50019,"Vermont","TROY",243,283,19,10,91,646
50019,"Vermont","WESTFIELD",134,123,6,11,30,304
50019,"Vermont","WESTMORE",103,93,7,4,9,216
50021,"Vermont","BENSON",216,232,23,10,27,508
50021,"Vermont","BRANDON",924,723,49,33,142,1871
50021,"Vermont","CASTLETON",795,808,39,22,127,1791
50021,"Vermont","CHITTENDEN",352,312,21,11,55,751
50021,"Vermont","CLARENDON",470,641,35,11,85,1242
50021,"Vermont","DANBY",252,291,39,15,44,641
50021,"Vermont","FAIR HAVEN",478,529,23,17,102,1149
50021,"Vermont","HUBBARDTON",188,163,12,6,20,389
50021,"Vermont","IRA",102,103,8,19,12,244
50021,"Vermont","KILLINGTON",357,232,29,10,33,661
50021,"Vermont","MENDON",302,268,26,10,32,638
50021,"Vermont","MIDDLETOWN SPRINGS",233,179,8,18,46,484
50021,"Vermont","MOUNT HOLLY",337,325,25,15,62,764
50021,"Vermont","MOUNT TABOR",45,42,5,0,3,95
50021,"Vermont","PAWLET",368,311,23,9,43,754
50021,"Vermont","PITTSFIELD",147,114,8,5,20,294
50021,"Vermont","PITTSFORD",668,669,65,19,106,1527
50021,"Vermont","POULTNEY",652,599,49,37,103,1440
50021,"Vermont","PROCTOR",385,339,34,12,74,844
50021,"Vermont","RUTLAND CITY",3495,2734,209,109,550,7097
50021,"Vermont","RUTLAND TOWN",1064,979,88,19,148,2298
50021,"Vermont","SHREWSBURY",325,269,16,9,42,661
50021,"Vermont","SUDBURY",163,122,12,3,19,319
50021,"Vermont","TINMOUTH",139,123,15,3,16,296
50021,"Vermont","WALLINGFORD",529,463,35,22,64,1113
50021,"Vermont","WELLS",209,312,17,6,31,575
50021,"Vermont","WEST HAVEN",56,56,0,7,14,133
50021,"Vermont","WEST RUTLAND",384,541,33,10,72,1040
50023,"Vermont","BARRE CITY",1653,1091,109,66,297,3216
50023,"Vermont","BARRE TOWN",1760,1862,139,55,352,4168
50023,"Vermont","BERLIN",658,454,51,31,162,1356
50023,"Vermont","CABOT",394,252,37,32,78,793
50023,"Vermont","CALAIS",688,195,21,42,74,1020
50023,"Vermont","DUXBURY",434,196,38,18,99,785
50023,"Vermont","EAST MONTPELIER",1032,356,41,62,119,1610
50023,"Vermont","FAYSTON",586,142,21,23,51,823
50023,"Vermont","MARSHFIELD",417,284,27,51,85,864
50023,"Vermont","MIDDLESEX",719,228,31,47,86,1111
50023,"Vermont","MONTPELIER",3698,492,98,208,275,4771
50023,"Vermont","MORETOWN",649,216,42,22,91,1020
50023,"Vermont","NORTHFIELD",1113,708,105,49,172,2147
50023,"Vermont","PLAINFIELD",424,129,16,42,65,676
50023,"Vermont","ROXBURY",186,118,21,14,36,375
50023,"Vermont","WAITSFIELD",751,210,29,35,86,1111
50023,"Vermont","WARREN",752,182,45,25,75,1079
50023,"Vermont","WATERBURY",2035,592,91,44,278,3040
50023,"Vermont","WOODBURY",271,169,18,18,51,527
50023,"Vermont","WORCESTER",374,117,19,27,57,594
50025,"Vermont","ATHENS",69,61,6,8,22,166
50025,"Vermont","BRATTLEBORO",4347,859,95,236,400,5937
50025,"Vermont","BROOKLINE",169,68,12,6,32,287
50025,"Vermont","DOVER",409,279,24,14,57,783
50025,"Vermont","DUMMERSTON",797,213,31,27,86,1154
50025,"Vermont","GRAFTON",210,131,14,6,29,390
50025,"Vermont","GUILFORD",719,274,29,44,99,1165
50025,"Vermont","HALIFAX",202,183,10,12,26,433
50025,"Vermont","JAMAICA",311,132,24,11,35,513
50025,"Vermont","LONDONDERRY",517,303,30,27,65,942
50025,"Vermont","MARLBORO",432,90,5,21,27,575
50025,"Vermont","NEWFANE",652,209,14,42,75,992
50025,"Vermont","PUTNEY",992,175,32,40,72,1311
50025,"Vermont","ROCKINGHAM",1315,576,75,46,143,2155
50025,"Vermont","STRATTON",65,50,2,0,9,126
50025,"Vermont","TOWNSHEND",412,174,17,10,69,682
50025,"Vermont","VERNON",492,486,50,11,83,1122
50025,"Vermont","WARDSBORO",199,137,12,11,33,392
50025,"Vermont","WESTMINSTER",1001,352,32,61,100,1546
50025,"Vermont","WHITINGHAM",283,285,22,10,42,642
50025,"Vermont","WILMINGTON",591,338,36,26,55,1046
50025,"Vermont","WINDHAM",156,79,10,8,23,276
50027,"Vermont","ANDOVER",166,125,8,4,27,330
50027,"Vermont","BALTIMORE",50,60,9,2,5,126
50027,"Vermont","BARNARD",339,174,13,11,32,569
50027,"Vermont","BETHEL",543,299,33,36,86,997
50027,"Vermont","BRIDGEWATER",280,160,11,13,58,522
50027,"Vermont","CAVENDISH",306,262,20,19,79,686
50027,"Vermont","CHESTER",827,512,47,34,126,1546
50027,"Vermont","HARTFORD",3190,1303,174,93,377,5137
50027,"Vermont","HARTLAND",1158,558,52,38,118,1924
50027,"Vermont","LUDLOW",538,403,28,23,98,1090
50027,"Vermont","NORWICH",1982,191,36,33,79,2321
50027,"Vermont","PLYMOUTH",173,125,13,9,28,348
50027,"Vermont","POMFRET",395,130,21,7,39,592
50027,"Vermont","READING",231,108,11,7,16,373
50027,"Vermont","ROCHESTER",393,162,17,17,54,643
50027,"Vermont","ROYALTON",698,406,46,31,136,1317
50027,"Vermont","SHARON",428,217,15,25,70,755
50027,"Vermont","SPRINGFIELD",1873,1510,144,85,341,3953
50027,"Vermont","STOCKBRIDGE",222,140,7,13,44,426
50027,"Vermont","WEATHERSFIELD",745,647,51,26,108,1577
50027,"Vermont","WESTON",267,106,8,5,28,414
50027,"Vermont","WEST WINDSOR",469,173,27,6,32,707
50027,"Vermont","WINDSOR",964,462,92,44,133,1695
50027,"Vermont","WOODSTOCK",1319,372,48,31,110,1880
51001,"Virginia","ACCOMACK COUNTY",6740,8583,264,66,165,15818
51003,"Virginia","ALBEMARLE COUNTY",33345,19259,2105,450,1567,56726
51005,"Virginia","ALLEGHANY COUNTY",2166,4874,164,35,86,7325
51007,"Virginia","AMELIA COUNTY",2128,4708,129,11,64,7040
51009,"Virginia","AMHERST COUNTY",5057,9719,317,65,238,15396
51011,"Virginia","APPOMATTOX COUNTY",2023,5715,136,31,92,7997
51013,"Virginia","ARLINGTON COUNTY",92016,20186,3827,819,4491,121339
51015,"Virginia","AUGUSTA COUNTY",8177,26163,1099,200,704,36343
51017,"Virginia","BATH COUNTY",603,1548,56,15,31,2253
51019,"Virginia","BEDFORD COUNTY",9768,30659,1074,176,848,42525
51021,"Virginia","BLAND COUNTY",453,2573,61,17,35,3139
51023,"Virginia","BOTETOURT COUNTY",4494,13375,497,101,272,18739
51025,"Virginia","BRUNSWICK COUNTY",4481,3046,72,25,45,7669
51027,"Virginia","BUCHANAN COUNTY",1721,7296,122,24,84,9247
51029,"Virginia","BUCKINGHAM COUNTY",3128,3950,102,27,82,7289
51031,"Virginia","CAMPBELL COUNTY",6664,19551,665,102,553,27535
51033,"Virginia","CAROLINE COUNTY",6432,7147,368,99,202,14248
51035,"Virginia","CARROLL COUNTY",2559,10663,220,69,144,13655
51036,"Virginia","CHARLES CITY COUNTY",2496,1476,67,15,53,4107
51037,"Virginia","CHARLOTTE COUNTY",2155,3479,111,11,51,5807
51041,"Virginia","CHESTERFIELD COUNTY",81074,85045,6247,990,3006,176362
51043,"Virginia","CLARKE COUNTY",3051,4661,261,55,185,8213
51045,"Virginia","CRAIG COUNTY",541,2140,54,20,36,2791
51047,"Virginia","CULPEPER COUNTY",7759,13349,584,176,350,22218
51049,"Virginia","CUMBERLAND COUNTY",2036,2697,95,24,54,4906
51051,"Virginia","DICKENSON COUNTY",1335,4932,81,14,78,6440
51053,"Virginia","DINWIDDIE COUNTY",5765,7447,196,46,121,13575
51057,"Virginia","ESSEX COUNTY",2542,2657,113,18,42,5372
51059,"Virginia","FAIRFAX COUNTY",355133,157710,15664,4477,18199,551183
51061,"Virginia","FAUQUIER COUNTY",12971,22127,1191,267,904,37460
51063,"Virginia","FLOYD COUNTY",2300,5293,185,107,165,8050
51065,"Virginia","FLUVANNA COUNTY",5760,7025,425,80,302,13592
51067,"Virginia","FRANKLIN COUNTY",7257,18569,602,115,428,26971
51069,"Virginia","FREDERICK COUNTY",11932,26083,1280,325,820,40440
51071,"Virginia","GILES COUNTY",1950,5910,201,39,112,8212
51073,"Virginia","GLOUCESTER COUNTY",5404,13096,693,134,292,19619
51075,"Virginia","GOOCHLAND COUNTY",4889,8384,474,54,236,14037
51077,"Virginia","GRAYSON COUNTY",1407,5592,110,55,121,7285
51079,"Virginia","GREENE COUNTY",2924,5945,406,66,266,9607
51081,"Virginia","GREENSVILLE COUNTY",2558,1737,50,6,12,4363
51083,"Virginia","HALIFAX COUNTY",6897,9704,237,44,112,16994
51085,"Virginia","HANOVER COUNTY",19382,39630,2310,314,1087,62723
51087,"Virginia","HENRICO COUNTY",93935,59857,5657,1081,3006,163536
51089,"Virginia","HENRY COUNTY",8198,15208,378,98,209,24091
51091,"Virginia","HIGHLAND COUNTY",371,958,33,8,21,1391
51093,"Virginia","ISLE OF WIGHT COUNTY",7881,12204,589,81,320,21075
51095,"Virginia","JAMES CITY COUNTY",19105,21306,1395,281,1082,43169
51097,"Virginia","KING & QUEEN COUNTY",1468,2099,75,18,30,3690
51099,"Virginia","KING GEORGE COUNTY",4007,7341,367,83,252,12050
51101,"Virginia","KING WILLIAM COUNTY",2760,5975,261,44,106,9146
51103,"Virginia","LANCASTER COUNTY",2869,3523,141,35,77,6645
51105,"Virginia","LEE COUNTY",1627,7543,106,33,90,9399
51107,"Virginia","LOUDOUN COUNTY",100795,69949,5674,1316,5316,183050
51109,"Virginia","LOUISA COUNTY",6212,10528,505,124,243,17612
51111,"Virginia","LUNENBURG COUNTY",2227,3204,88,25,42,5586
51113,"Virginia","MADISON COUNTY",2203,4419,184,43,130,6979
51115,"Virginia","MATHEWS COUNTY",1563,3517,147,31,53,5311
51117,"Virginia","MECKLENBURG COUNTY",6285,8288,239,30,103,14945
51119,"Virginia","MIDDLESEX COUNTY",2108,3670,140,33,66,6017
51121,"Virginia","MONTGOMERY COUNTY",20021,19459,2026,401,1124,43031
51125,"Virginia","NELSON COUNTY",3689,4154,244,81,143,8311
51127,"Virginia","NEW KENT COUNTY",3546,8118,348,52,169,12233
51131,"Virginia","NORTHAMPTON COUNTY",3255,2686,116,40,71,6168
51133,"Virginia","NORTHUMBERLAND COUNTY",2852,4302,136,21,86,7397
51135,"Virginia","NOTTOWAY COUNTY",2829,3712,116,25,62,6744
51137,"Virginia","ORANGE COUNTY",5957,10521,399,116,274,17267
51139,"Virginia","PAGE COUNTY",2514,7831,198,38,159,10740
51141,"Virginia","PATRICK COUNTY",1768,6454,147,49,107,8525
51143,"Virginia","PITTSYLVANIA COUNTY",9199,21554,442,106,297,31598
51145,"Virginia","POWHATAN COUNTY",4060,11885,639,73,231,16888
51147,"Virginia","PRINCE EDWARD COUNTY",4591,4101,286,53,112,9143
51149,"Virginia","PRINCE GEORGE COUNTY",6419,9157,374,70,164,16184
51153,"Virginia","PRINCE WILLIAM COUNTY",113144,71721,5374,1497,4706,196442
51155,"Virginia","PULASKI COUNTY",4172,10322,351,107,213,15165
51157,"Virginia","RAPPAHANNOCK COUNTY",1747,2539,93,36,68,4483
51159,"Virginia","RICHMOND COUNTY",1347,2213,57,13,31,3661
51161,"Virginia","ROANOKE COUNTY",17200,31408,1620,286,975,51489
51163,"Virginia","ROCKBRIDGE COUNTY",3508,6680,271,66,270,10795
51165,"Virginia","ROCKINGHAM COUNTY",9366,25990,1088,208,835,37487
51167,"Virginia","RUSSELL COUNTY",2330,9521,190,58,147,12246
51169,"Virginia","SCOTT COUNTY",1581,8247,142,39,91,10100
51171,"Virginia","SHENANDOAH COUNTY",5273,14094,556,149,436,20508
51173,"Virginia","SMYTH COUNTY",2665,9750,258,53,164,12890
51175,"Virginia","SOUTHAMPTON COUNTY",3595,5035,156,24,62,8872
51177,"Virginia","SPOTSYLVANIA COUNTY",24207,34623,1910,450,1359,62549
51179,"Virginia","STAFFORD COUNTY",27908,33868,2140,488,1530,65934
51181,"Virginia","SURRY COUNTY",2272,1819,81,17,39,4228
51183,"Virginia","SUSSEX COUNTY",2879,2055,63,22,25,5044
51185,"Virginia","TAZEWELL COUNTY",2895,15168,260,53,190,18566
51187,"Virginia","WARREN COUNTY",5169,11773,495,149,365,17951
51191,"Virginia","WASHINGTON COUNTY",5553,19320,537,93,343,25846
51193,"Virginia","WESTMORELAND COUNTY",3836,4448,157,40,93,8574
51195,"Virginia","WISE COUNTY",2701,12086,182,77,117,15163
51197,"Virginia","WYTHE COUNTY",2770,10046,285,49,178,13328
51199,"Virginia","YORK COUNTY",12999,18837,1186,252,839,34113
51510,"Virginia","ALEXANDRIA CITY",57242,13285,2020,592,2623,75762
51520,"Virginia","BRISTOL CITY",1835,4892,136,50,114,7027
51530,"Virginia","BUENA VISTA CITY",693,1430,83,13,188,2407
51540,"Virginia","CHARLOTTESVILLE CITY",17901,2960,785,230,591,22467
51550,"Virginia","CHESAPEAKE CITY",52627,54047,3458,698,1832,112662
51570,"Virginia","COLONIAL HEIGHTS CITY",2367,5681,247,44,118,8457
51580,"Virginia","COVINGTON CITY",914,1349,73,8,38,2382
51590,"Virginia","DANVILLE CITY",11059,7303,315,73,190,18940
51595,"Virginia","EMPORIA CITY",1530,789,26,10,11,2366
51600,"Virginia","FAIRFAX CITY",7367,3702,427,107,425,12028
51610,"Virginia","FALLS CHURCH CITY",5819,1324,237,70,307,7757
51620,"Virginia","FRANKLIN CITY",2519,1421,72,16,33,4061
51630,"Virginia","FREDERICKSBURG CITY",6707,3744,389,137,280,11257
51640,"Virginia","GALAX CITY",681,1603,45,7,40,2376
51650,"Virginia","HAMPTON CITY",41312,17902,1658,474,931,62277
51660,"Virginia","HARRISONBURG CITY",10212,6262,810,255,448,17987
51670,"Virginia","HOPEWELL CITY",4724,3885,212,58,129,9008
51678,"Virginia","LEXINGTON CITY",1514,766,92,20,73,2465
51680,"Virginia","LYNCHBURG CITY",14792,17982,1379,208,1296,35657
51683,"Virginia","MANASSAS CITY",8423,5953,488,147,400,15411
51685,"Virginia","MANASSAS PARK CITY",3204,1733,162,45,88,5232
51690,"Virginia","MARTINSVILLE CITY",3533,2149,114,29,82,5907
51700,"Virginia","NEWPORT NEWS CITY",45618,25468,2531,591,1429,75637
51710,"Virginia","NORFOLK CITY",57023,21552,2717,797,1296,83385
51720,"Virginia","NORTON CITY",383,1021,24,6,26,1460
51730,"Virginia","PETERSBURG CITY",12021,1451,139,67,108,13786
51735,"Virginia","POQUOSON CITY",1601,5092,307,43,134,7177
51740,"Virginia","PORTSMOUTH CITY",28497,12795,1096,323,550,43261
51750,"Virginia","RADFORD CITY",2925,2638,301,58,160,6082
51760,"Virginia","RICHMOND CITY",81259,15581,3617,1134,1815,103406
51770,"Virginia","ROANOKE CITY",22286,14789,1316,411,664,39466
51775,"Virginia","SALEM CITY",4202,7226,442,92,263,12225
51790,"Virginia","STAUNTON CITY",5333,5133,419,109,261,11255
51800,"Virginia","SUFFOLK CITY",23280,18006,1098,223,633,43240
51810,"Virginia","VIRGINIA BEACH CITY",91032,98224,8255,1737,3771,203019
51820,"Virginia","WAYNESBORO CITY",3764,4801,336,74,229,9204
51830,"Virginia","WILLIAMSBURG CITY",5206,1925,231,84,180,7626
51840,"Virginia","WINCHESTER CITY",5164,4790,400,99,212,10665
53001,"Washington","Adams",1299,3083,183,22,57,4644
53003,"Washington","Asotin",3134,5741,624,117,120,9736
53005,"Washington","Benton",26360,47194,4819,874,780,80027
53007,"Washington","Chelan",13032,18114,1504,480,250,33380
53009,"Washington","Clallam",17677,18794,1838,810,338,39457
53011,"Washington","Clark",92757,92441,10076,3344,1542,200160
53013,"Washington","Columbia",526,1497,109,26,24,2182
53015,"Washington","Cowlitz",17908,24185,2343,787,469,45692
53017,"Washington","Douglas",4918,9603,714,185,123,15543
53019,"Washington","Ferry",1098,2202,191,58,52,3601
53021,"Washington","Franklin",8886,13206,1148,225,255,23720
53023,"Washington","Garfield",279,851,88,14,14,1246
53025,"Washington","Grant",7810,18518,1387,291,340,28346
53027,"Washington","Grays Harbor",12020,14067,1443,568,269,28367
53029,"Washington","Island",20960,18465,2319,807,325,42876
53031,"Washington","Jefferson",12656,6037,746,706,131,20276
53033,"Washington","King",718322,216339,40861,17704,5273,998499
53035,"Washington","Kitsap",63156,49018,8596,2397,1150,124317
53037,"Washington","Kittitas",7489,10100,908,315,143,18955
53039,"Washington","Klickitat",4194,5789,463,217,106,10769
53041,"Washington","Lewis",9654,21992,1664,514,325,34149
53043,"Washington","Lincoln",1244,4108,252,50,59,5713
53045,"Washington","Mason",11993,13677,1560,556,287,28073
53047,"Washington","Okanogan",6298,9610,713,291,179,17091
53049,"Washington","Pacific",4620,5360,436,200,100,10716
53051,"Washington","Pend Oreille",1934,4373,323,99,73,6802
53053,"Washington","Pierce",172538,146824,19909,6144,3070,348485
53055,"Washington","San Juan",7172,2688,402,467,45,10774
53057,"Washington","Skagit",26690,24736,3090,1006,446,55968
53059,"Washington","Skamania",2232,2928,285,139,55,5639
53061,"Washington","Snohomish",185227,128255,19347,6396,2948,342173
53063,"Washington","Spokane",93767,113435,13227,4185,2632,227246
53065,"Washington","Stevens",5767,15161,1134,307,308,22677
53067,"Washington","Thurston",68798,48624,7306,3584,1098,129410
53069,"Washington","Wahkiakum",832,1344,111,50,21,2358
53071,"Washington","Walla Walla",9694,13651,1435,386,253,25419
53073,"Washington","Whatcom",60340,40599,4837,3005,892,109673
53075,"Washington","Whitman",8146,7403,1227,317,212,17305
53077,"Washington","Yakima",31291,41735,3261,774,689,77750
54001,"West Virginia","Barbour",1222,4527,214,64,27,6054
54003,"West Virginia","Berkeley",12321,28244,1623,473,189,42850
54005,"West Virginia","Boone",1790,6504,246,70,73,8683
54007,"West Virginia","Braxton",1321,3537,157,47,28,5090
54009,"West Virginia","Brooke",2568,6625,297,99,24,9613
54011,"West Virginia","Cabell",11447,19850,1209,397,182,33085
54013,"West Virginia","Calhoun",456,2035,63,45,18,2617
54015,"West Virginia","Clay",568,2300,60,25,19,2972
54017,"West Virginia","Doddridge",362,2358,65,37,18,2840
54019,"West Virginia","Fayette",4290,10357,443,180,67,15337
54021,"West Virginia","Gilmer",545,1896,68,24,10,2543
54023,"West Virginia","Grant",512,4346,65,21,12,4956
54025,"West Virginia","Greenbrier",3765,9556,475,200,70,14066
54027,"West Virginia","Hampshire",1580,6692,196,103,37,8608
54029,"West Virginia","Hancock",3262,8909,370,125,36,12702
54031,"West Virginia","Hardy",1155,4274,140,42,32,5643
54033,"West Virginia","Harrison",7694,18750,1041,327,148,27960
54035,"West Virginia","Jackson",2663,9020,305,106,93,12187
54037,"West Virginia","Jefferson",9518,13204,1005,333,87,24147
54039,"West Virginia","Kanawha",28263,43850,2494,814,269,75690
54041,"West Virginia","Lewis",1347,5274,209,69,29,6928
54043,"West Virginia","Lincoln",1459,5307,191,62,47,7066
54045,"West Virginia","Logan",2092,9897,237,85,48,12359
54047,"West Virginia","McDowell",1438,4629,90,27,19,6203
54049,"West Virginia","Marion",6964,14668,899,367,131,23029
54051,"West Virginia","Marshall",2918,9666,418,153,61,13216
54053,"West Virginia","Mason",2081,7654,276,86,89,10186
54055,"West Virginia","Mercer",4704,17404,552,209,113,22982
54057,"West Virginia","Mineral",2050,9070,282,123,39,11564
54059,"West Virginia","Mingo",1370,7911,145,32,52,9510
54061,"West Virginia","Monongalia",14699,18432,1827,815,275,36048
54063,"West Virginia","Monroe",1111,4443,149,57,45,5805
54065,"West Virginia","Morgan",1573,5732,208,103,38,7654
54067,"West Virginia","Nicholas",1840,7251,283,83,34,9491
54069,"West Virginia","Ohio",5493,11139,748,384,174,17938
54071,"West Virginia","Pendleton",729,2398,73,18,7,3225
54073,"West Virginia","Pleasants",621,2358,123,20,28,3150
54075,"West Virginia","Pocahontas",928,2496,150,57,15,3646
54077,"West Virginia","Preston",2470,9538,429,131,91,12659
54079,"West Virginia","Putnam",5884,17788,823,265,133,24893
54081,"West Virginia","Raleigh",6443,22048,687,252,188,29618
54083,"West Virginia","Randolph",2735,7629,339,95,78,10876
54085,"West Virginia","Ritchie",496,3405,105,40,29,4075
54087,"West Virginia","Roane",1222,3781,143,65,36,5247
54089,"West Virginia","Summers",1190,3455,137,57,23,4862
54091,"West Virginia","Taylor",1491,4733,194,77,43,6538
54093,"West Virginia","Tucker",751,2565,103,46,10,3475
54095,"West Virginia","Tyler",507,2996,103,25,23,3654
54097,"West Virginia","Upshur",1766,7005,310,89,48,9218
54099,"West Virginia","Wayne",3357,11152,421,122,130,15182
54101,"West Virginia","Webster",556,2302,82,30,8,2978
54103,"West Virginia","Wetzel",1359,4519,245,66,76,6265
54105,"West Virginia","Wirt",386,1911,84,24,17,2422
54107,"West Virginia","Wood",8400,25434,1266,371,144,35615
54109,"West Virginia","Wyoming",1062,6547,137,38,47,7831
55001,"Wisconsin","ADAMS",3770,5983,207,80,72,10112
55003,"Wisconsin","ASHLAND",4228,3302,192,167,54,7943
55005,"Wisconsin","BARRON",7879,13606,727,169,190,22571
55007,"Wisconsin","BAYFIELD",4954,4125,197,185,64,9525
55009,"Wisconsin","BROWN",53364,67199,4984,1371,884,127802
55011,"Wisconsin","BUFFALO",2531,4049,218,74,58,6930
55013,"Wisconsin","BURNETT",2948,5412,236,67,80,8743
55015,"Wisconsin","CALUMET",9646,15348,1053,204,301,26552
55017,"Wisconsin","CHIPPEWA",11886,17909,1220,264,282,31561
55019,"Wisconsin","CLARK",4227,8646,455,109,159,13596
55021,"Wisconsin","COLUMBIA",13526,14160,1092,347,264,29389
55023,"Wisconsin","CRAWFORD",3425,3844,277,73,82,7701
55025,"Wisconsin","DANE",217526,71279,10544,4314,1987,305650
55027,"Wisconsin","DODGE",13968,26643,1539,361,554,43065
55029,"Wisconsin","DOOR",8026,8584,558,145,143,17456
55031,"Wisconsin","DOUGLAS",11345,9659,723,337,165,22229
55033,"Wisconsin","DUNN",9026,11488,1094,294,189,22091
55035,"Wisconsin","EAU CLAIRE",27294,23311,2496,699,554,54354
55037,"Wisconsin","FLORENCE",666,1897,64,17,13,2657
55039,"Wisconsin","FOND DU LAC",17391,31044,1910,449,533,51327
55041,"Wisconsin","FOREST",1584,2788,80,37,24,4513
55043,"Wisconsin","GRANT",10046,12349,1159,308,237,24099
55045,"Wisconsin","GREEN",9122,8693,687,196,131,18829
55047,"Wisconsin","GREEN LAKE",2701,6213,274,75,91,9354
55049,"Wisconsin","IOWA",6669,4809,456,115,82,12131
55051,"Wisconsin","IRON",1273,2090,72,34,11,3480
55053,"Wisconsin","JACKSON",3821,4907,300,108,89,9225
55055,"Wisconsin","JEFFERSON",16561,23410,1660,462,493,42586
55057,"Wisconsin","JUNEAU",4073,7123,280,105,81,11662
55059,"Wisconsin","KENOSHA",35771,36025,2719,861,644,76020
55061,"Wisconsin","KEWAUNEE",3623,6616,348,79,92,10758
55063,"Wisconsin","LA CROSSE",32406,26389,2673,920,580,62968
55065,"Wisconsin","LAFAYETTE",3288,3977,238,49,66,7618
55067,"Wisconsin","LANGLADE",3260,6436,279,67,59,10101
55069,"Wisconsin","LINCOLN",5370,8400,596,114,84,14564
55071,"Wisconsin","MANITOWOC",14506,23193,1558,346,420,40023
55073,"Wisconsin","MARATHON",26477,39013,2330,641,523,68984
55075,"Wisconsin","MARINETTE",6243,12995,520,131,157,20046
55077,"Wisconsin","MARQUETTE",2809,4714,187,50,88,7848
55078,"Wisconsin","MENOMINEE",1003,269,0,7,0,1279
55079,"Wisconsin","MILWAUKEE",288797,125846,13590,4529,3136,435898
55081,"Wisconsin","MONROE",7048,11352,701,230,191,19522
55083,"Wisconsin","OCONTO",5884,13253,581,118,142,19978
55085,"Wisconsin","ONEIDA",8104,11677,751,191,170,20893
55087,"Wisconsin","OUTAGAMIE",38087,49884,3931,985,981,93868
55089,"Wisconsin","OZAUKEE",20168,30430,2110,387,731,53826
55091,"Wisconsin","PEPIN",1345,2206,115,33,40,3739
55093,"Wisconsin","PIERCE",8382,11258,1044,281,189,21154
55095,"Wisconsin","POLK",7570,13815,886,232,168,22671
55097,"Wisconsin","PORTAGE",18521,17306,1490,583,304,38204
55099,"Wisconsin","PRICE",2669,4562,200,84,62,7577
55101,"Wisconsin","RACINE",42512,46611,3248,834,928,94133
55103,"Wisconsin","RICHLAND",3577,4023,242,107,70,8019
55105,"Wisconsin","ROCK",39343,31488,2859,885,586,75161
55107,"Wisconsin","RUSK",2171,4564,197,63,71,7066
55109,"Wisconsin","ST. CROIX",17486,26220,2338,513,518,47075
55111,"Wisconsin","SAUK",14692,14791,1106,424,305,31318
55113,"Wisconsin","SAWYER",3504,5185,210,99,41,9039
55115,"Wisconsin","SHAWANO",6056,12742,608,172,173,19751
55117,"Wisconsin","SHEBOYGAN",22956,32458,2376,544,775,59109
55119,"Wisconsin","TAYLOR",2398,6589,293,69,90,9439
55121,"Wisconsin","TREMPEALEAU",5636,7364,384,117,109,13610
55123,"Wisconsin","VERNON",6352,6996,447,290,128,14213
55125,"Wisconsin","VILAS",4770,8169,340,116,74,13469
55127,"Wisconsin","WALWORTH",18706,28851,2118,612,562,50849
55129,"Wisconsin","WASHBURN",3284,5404,271,64,68,9091
55131,"Wisconsin","WASHINGTON",20855,51729,2745,548,821,76698
55133,"Wisconsin","WAUKESHA",79200,142521,8891,1674,2437,234723
55135,"Wisconsin","WAUPACA",8440,16189,800,240,198,25867
55137,"Wisconsin","WAUSHARA",3792,7669,326,96,116,11999
55139,"Wisconsin","WINNEBAGO",37054,43448,3820,1063,825,86210
55141,"Wisconsin","WOOD",14232,21503,1365,392,308,37800
56001,"Wyoming","Albany",6890,7602,1391,344,1018,17245
56003,"Wyoming","Big Horn",604,4067,242,35,458,5406
56005,"Wyoming","Campbell",1324,15778,653,66,530,18351
56007,"Wyoming","Carbon",1279,4409,381,49,343,6461
56009,"Wyoming","Converse",668,5520,251,42,225,6706
56011,"Wyoming","Crook",273,3348,118,11,116,3866
56013,"Wyoming","Fremont",4200,11167,773,233,868,17241
56015,"Wyoming","Goshen",924,4418,234,45,259,5880
56017,"Wyoming","Hot Springs",400,1939,136,35,134,2644
56019,"Wyoming","Johnson",638,3477,174,33,150,4472
56021,"Wyoming","Laramie",11573,24847,2657,434,1842,41353
56023,"Wyoming","Lincoln",1105,6779,331,48,707,8970
56025,"Wyoming","Natrona",6577,23552,1791,310,1487,33717
56027,"Wyoming","Niobrara",115,1116,49,7,44,1331
56029,"Wyoming","Park",2535,11115,625,151,885,15311
56031,"Wyoming","Platte",719,3437,180,36,208,4580
56033,"Wyoming","Sheridan",2927,10266,729,158,621,14701
56035,"Wyoming","Sublette",644,3409,169,28,192,4442
56037,"Wyoming","Sweetwater",3231,12154,928,152,844,17309
56039,"Wyoming","Teton",7314,3921,701,172,687,12795
56041,"Wyoming","Uinta",1202,6154,472,79,663,8570
56043,"Wyoming","Washakie",532,2911,194,37,191,3865
56045,"Wyoming","Weston",299,3033,108,10,122,3572
